context1	context2	label
I spent my [ spring ] holidays in Morocco .	season time_of_year	T
[ home ] is where the heart is	environment	T
in Japan most [ fish ] is eaten raw	food solid_food	T
A normal [ year ] has 365 full days , but there are 366 days in a leap year .	time_period period_of_time period	T
There was a tension in the [ air ] which made me suspect an approaching storm .	gas	T
he said he was looking for the [ way ] out	artifact artefact	T
Europe considered as a [ whole ]	concept conception construct	T
his [ move ] put him directly in my path	change	T
He needs to make this shot for [ par ] .	score	T
he was on the heavy [ side ]	aspect facet	T
a [ master ] of the violin	artist creative_person	T
he has an artist 's [ eye ]	sagacity sagaciousness judgment judgement discernment	T
A hermit does n't much care for [ civilization ] .	society	T
Can I have a [ word ] with you ?	statement	T
while there 's [ life ] there 's hope	being beingness existence	T
during the firework display that ended the gala the [ noise ] reached 98 decibels	sound	T
That old piano is just a big dust [ collector ] .	person individual someone somebody mortal soul	T
I do n't think we have the red one in your [ size ] .	property	T
Her cancer was in [ remission ] .	suspension respite reprieve hiatus abatement	T
a [ miasma ] of cigar smoke	air_pollution	T
sugar [ loaf ]	food solid_food	T
Our choice of concrete will have a tremendous [ impact ] on the building 's mechanical performance .	consequence effect outcome result event issue upshot	T
Where is the departure gate for [ flight ] 747 ? / Go straight down and to the right .	trip	T
General Smith was placed in [ command ] .	authority authorization authorisation potency dominance say-so	T
he called each flip of the coin a new [ trial ]	attempt effort endeavor endeavour try	T
they funded research and [ development ]	improvement	T
a [ drop ] of each sample was analyzed	small_indefinite_quantity small_indefinite_amount	T
moral [ bankruptcy ]	failure	T
[ origin ] in sensation	source	T
hastened the [ period ] of time of his recovery	fundamental_quantity fundamental_measure	T
he was surrounded by a [ bevy ] of beauties in bathing attire	gathering assemblage	T
the [ image ] of f(x ) = x^2 is the set of all non - negative real numbers if the domain of the function is the set of all real numbers	set	T
All I need to weather a snowstorm is hot coffee , a warm fire , a good book and a comfortable [ chair ] .	seat	T
such images define their sense of [ nationality ]	people	T
the [ head ] of the column advanced boldly	formation	T
she had heard her [ fill ] of gossip	enough sufficiency	T
[ tea ] has fragrant white flowers	shrub bush	T
They shot 20 [ head ] of quail	domestic_animal domesticated_animal	T
deliver the package to my [ home ]	residence abode	T
a [ school ] of small glittering fish swam by	animal_group	T
he described his mental [ picture ] of his assailant	image mental_image	T
he had to clean up the [ leak ]	discharge outpouring run	T
a racially integrated business [ concern ]	enterprise	T
a [ sampler ] of French poets	assortment mixture mixed_bag miscellany miscellanea variety salmagundi smorgasbord potpourri motley	T
The mechanism for [ arousal ] from sleep	wakefulness	T
A tidy [ sum ]	assets	T
He sat on the arm of the chair rather than the [ seat ] , which always annoyed his mother .	furniture piece_of_furniture article_of_furniture	T
Okay , but this is the last [ time ] . No more after that !	case instance example	T
he went to the party dressed in [ drag ]	clothing article_of_clothing vesture wear wearable habiliment	T
the gas expanded to twice its original [ volume ]	measure quantity amount	T
I 'm really seeing you in a different [ light ] today .	friend	T
the [ acquisition ] of wealth	acquiring getting	T
The announcement of the verdict brought a violent [ reaction ] .	bodily_process body_process bodily_function activity	T
the body lay in a [ pool ] of blood	body_of_water water	T
The lawyer obtained impunity by dragging his obviously guilty client 's case beyond the 10 years [ limitation ]	time_limit	T
The [ emission ] of light from the sun	egress egression emergence	T
a terrible feeling of [ ulteriority ]	quality	T
men first stepped on the [ moon ] in 1969		T
he was university [ material ]	applicant applier	T
the consolidation of the United States ' [ hegemony ] over a new international economic system	political_system form_of_government	T
they paid taxes on every stage of the [ operation ]	business_activity commercial_activity	T
Do you want to come over to my [ place ] later ?	residence abode	T
the [ process ] of calcification begins later for boys than for girls	physical_entity	T
a bark [ feeder ]	animal animate_being beast brute creature fauna	T
they have a chef who specializes in [ fish ]	food solid_food	T
They climbed the north [ face ] of the mountain .	surface	T
in chess your should take care of your [ development ] before moving your queen	improvement melioration	T
The shift of the supplier gave us a [ saving ] of 10 percent .	action	T
Yesterday we did a [ run ] of 12,000 units .	indefinite_quantity	T
he was the [ last ] to leave	rank	T
We laughed at her because the [ label ] was still on her new sweater .	marker marking mark	T
It was then that they decided to found a [ society ] of didgeridoo - playing unicyclists .	association	T
The [ key ] to winning a game	explanation	T
his support made a real [ difference ]	change	T
the piano had a very stiff [ action ]	mechanism	T
the plane was given [ clearance ] to land	license permission permit	T
the smart [ set ] goes there	social_group	T
I resented his [ withholding ] permission	retention keeping holding	T
he managed it on a [ shoestring ]	small_indefinite_quantity small_indefinite_amount	T
I ordered two [ dozen ] doughnuts .	large_integer	T
a distant [ third ]	rank	T
I took the noon [ flight ] to Chicago	trip	T
the [ light ] of my life	friend	T
he wrote the date on the [ back ] of the photograph	side	T
the [ foot ] of the page	bottom	T
See you another [ time ] ;    that 's three times he 's made the same mistake	case instance example	T
Genesis is the first [ book ] of the Bible .	section subdivision	T
a long and happy [ marriage ]	marital_status	T
Come in , out of the [ cold ] .	temperature	T
12 [ head ] of big cattle and 14 head of branded calves	domestic_animal domesticated_animal	T
he feared that mentioning it might reopen the [ wound ]	distress hurt suffering	T
he was given [ credit ] for his work	approval commendation	T
he held a large [ block ] of the company 's stock	collection aggregation accumulation assemblage	T
his [ ambition ] is to own his own business	desire	T
There will be a [ charge ] of five dollars .	cost	T
The flock of birds took to the [ air ] .	gas	T
the [ patter ] of mice	sound	T
the [ line ] stretched clear around the corner	formation	T
A circle is the [ locus ] of points from which the distance to the center is a given value , the radius .	set	T
mouths which speak such [ foulness ] must be cleansed	iniquity wickedness darkness dark	T
Please speak up , the [ line ] is very faint .	connection connexion connector connecter connective	T
The [ term ] allowed to a debtor to discharge his debt	time_period period_of_time period	T
Family members had been buried in the [ vault ] for centuries .	burial_chamber sepulcher sepulchre sepulture	T
he threw the ball into the [ air ]	region part	T
the African - American [ population ] of Salt Lake City has been increasing	integer whole_number	T
he had a [ time ] holding back the tears	experience	T
there but for the [ grace ] of God go I	beneficence	T
Open the door a [ crack ] .	opening gap	T
the [ truth ] is that he did n't want to do it	fact	T
the shark is a large [ fish ]	aquatic_vertebrate	T
the [ language ] introduced is standard throughout the text	communication	T
she made a [ funny ]	joke gag laugh jest jape	T
The [ use ] of torture has been condemned by the United Nations ;    there is no use for your invention	activity	T
the manager had only four starting pitchers in his [ rotation ]	sequence chronological_sequence succession successiveness chronological_succession	T
they held an [ inventory ] every month	listing itemization itemisation	T
they found the [ body ] in the lake	natural_object	T
you can obtain a [ transcript ] of this radio program by sending a self - addressed envelope to the station	writing written_material piece_of_writing	T
The Holocaust was insanity on an enormous [ scale ] .	proportion	T
his brother 's success left him in the [ shade ]	inferiority lower_status lower_rank	T
At the [ end ] of the road , turn left .     At the end of the story , the main characters fall in love .	part section division	T
a [ congregation ] of children pleaded for his autograph	collection aggregation accumulation assemblage	T
It 's almost [ lunchtime ] , so I think I 'll finish up later this afternoon .	mealtime	T
the [ foot ] of the list	bottom	T
Do n't go to lunch if we do n't have enough [ coverage ] for the help - desk phones .	extent	T
The woman does not even have one stick of [ furniture ] moved in yet .	furnishing	T
With the lights out , she had to rely on [ touch ] to find her desk .	exteroception	T
Liza had always had a tendency to [ wildness ]	unruliness fractiousness willfulness wilfulness	T
The [ role ] of women has changed significantly in the last century .	activity	T
The CEO made a public [ apology ] for the scandal , and promised full cooperation with the authorities .	acknowledgment acknowledgement	T
mineral [ origin ]	source	T
a bird will not learn its [ song ] unless it hears it at an early age	animal_communication	T
he does not have a [ grain ] of sense	smallness littleness	T
The point guard drove toward the [ basket ] .	basketball_equipment	T
" Are we having a recording [ session ] ? " / " Yes . We 've even got some session musicians to provide some brass . "	meeting coming_together	T
skill is the [ product ] of hours of practice	consequence effect outcome result event issue upshot	T
the boat had a metallic [ finish ]	decorativeness	T
He always puts a [ smile ] on my face .	facial_expression facial_gesture	T
we were just waiting for someone to take the [ lead ]	leadership leading	T
Before laying sod on that clay , the ground needs two inches of [ coverage ] with topsoil .	extent	T
political [ fatigue ]	boredom ennui tedium	T
the [ baby ] of the family	offspring progeny issue	T
" driver " , noun : [ one ] who drives .	unit	T
The word " kerosine " is a [ variant ] of “ kerosene ” .	type	T
life has lost its [ point ]	meaning significance signification import	T
he could be Gingrich 's [ double ]	person individual someone somebody mortal soul	T
I give you [ credit ] for owning up to your mistake .	approval commendation	T
she did n't appreciate my [ humor ]	playfulness fun	T
19th century [ thought ]	belief	T
The [ fabric ] of our lives	structure	T
the south [ wall ] had a small window	partition divider	T
The " [ war ] on drugs " is a campaign against the use of narcotic drugs .	campaign cause crusade drive movement effort	T
[ business ] is good today	business_activity commercial_activity	T
a [ flash ] sewn on his sleeve indicated the unit he belonged to	patch	T
the trunk was full of [ stuff ]	object physical_object	T
the [ taproot ] of his resentment	source seed germ	T
they had [ sex ] in the back seat	bodily_process body_process bodily_function activity	T
The crazy lady made a [ scene ] in the grocery store .	photograph photo exposure picture pic	T
She could n't hurt a fly , young [ slip ] of a girl that she is .	young_person youth younker spring_chicken	T
Pancake [ syrup ]	sweetening sweetener	T
computers are now widely used in [ business ]	commerce commercialism mercantilism	T
a body will continue in a state of [ rest ] until acted upon	inaction inactivity inactiveness	T
the [ containment ] of the rebellion	restraint	T
He was sentenced to a [ term ] of six years in prison .	time_period period_of_time period	T
true [ memorability ] of phrase	quality	T
they rode to the [ end ] of the line	extremity	T
The [ significance ] of a gesture	meaning substance	T
Gilbert had some bad [ luck ] yesterday — he got pick - pocketed and lost fifty dollars .	phenomenon	T
We had [ sex ] in the back seat .	bodily_process body_process bodily_function activity	T
a multinational [ operation ]	business_activity commercial_activity	T
I could hear the [ breath ] of the runner behind me .	bodily_process body_process bodily_function activity	T
I tried to make a call , but the [ line ] was dead .	connection connexion connector connecter connective	T
" Under his proud [ survey ] the city lies . " -Sir John Denham .	look looking looking_at	T
The most moving [ scene ] is the final one , where he realizes he has wasted his whole life .	dramatic_composition dramatic_work	T
What is all that [ stuff ] on your bedroom floor ?	object physical_object	T
the [ enemy ] attacked at dawn	military_unit military_force military_group force	T
There 's a cranky [ curmudgeon ] working at the hospital who gives all the patients and other doctors flak .	oldster old_person senior_citizen golden_ager	T
Oi , you , shut your [ gob ] !	mouth oral_cavity oral_fissure rima_oris	T
the [ institution ] of slavery	custom tradition	T
open a window and let in some [ air ]	gas	T
someone had to drive me home last night because I had a [ skinful ]	indefinite_quantity	T
A shared [ line ]	connection connexion connector connecter connective	T
the store shelves held many different kinds of [ tea ]	herb	T
the [ space ] between his teeth	amorphous_shape	T
a critical time in the school 's [ history ]	past past_times yesteryear	T
it 's a [ quarter ] til 4	time_unit unit_of_time	T
in the [ deep ] of winter	middle	T
the mother provides emotional [ anchorage ] for the entire family	condition status	T
he thought of his painting as a [ game ] that filled his empty time	diversion recreation	T
fish with a delicate flavor and [ texture ]	constitution composition physical_composition makeup make-up	T
a good [ shot ] requires good balance and tempo	maneuver manoeuvre play	T
Jones came in [ third ] .	rank	T
Penny was in the scullery , pressing the [ body ] of her new dress .	body_part	T
He got [ clearance ] to travel to America , even though he had previous links to terrorists	license permission permit	T
We do [ business ] all over the world .	commerce commercialism mercantilism	T
are your [ people ] still alive ?	family family_line folk kinfolk kinsfolk sept phratry	T
The Grim Reaper is a [ personification ] of death .	person individual someone somebody mortal soul	T
When I realized that I had hurt my friend , I felt deep [ shame ] .	dishonor dishonour	T
the [ voice ] of the law	means agency way	T
Our football team took a [ licking ] last night .	ending conclusion finish	T
he stared as she buttoned her [ top ]	woman's_clothing	T
the pilot ran through the [ check ] - out procedure	inspection review	T
" Open your [ mouth ] and say ' aah ' , " directed the doctor .	rima	T
I asked for a hot [ drink ]	helping portion serving	T
he is the very [ model ] of a modern major general	ideal	T
The sun sets , and the workers go to their [ rest ] .	inactivity	T
it is much cooler in the [ shade ]	semidarkness	T
you did n't give me enough [ notice ]	announcement promulgation	T
Fred is becoming a [ bum ] - he 's not even bothering to work more than once a month .	nonworker	T
a [ wall ] of water	object physical_object	T
the [ scale ] of the map	proportion	T
The [ date ] of a letter , of a will , of a deed , of a coin , etc .	calendar_day civil_day	T
this [ time ] he succeeded	case instance example	T
when the [ finish ] is too thin it is difficult to apply evenly	decorativeness	T
the [ reenactment ] of the battle of Princeton	acting playing playacting performing	T
They did nearly a million dollars of [ business ] over the long weekend .	business_activity commercial_activity	T
I was invited to the [ masquerade ] at their home .	pretense pretence pretending simulation feigning	T
A chair is [ furniture ] . Sofas are also furniture .	furnishing	T
ocean [ circulation ] is an important part of global climate	change_of_location travel	T
From noon till [ night ]	twilight dusk gloaming gloam nightfall evenfall fall crepuscule crepuscle	T
he washed his [ face ]	external_body_part	T
The enemy fire is increasing – can we get some immediate [ coverage ] from those bunkers ?	extent	T
We all got to ride the merry - go - round when the brought their [ carnival ] to town .	festival fete	T
he made his [ escape ] from the mental hospital	running_away	T
he was a great actor in his [ time ]	time_period period_of_time period	T
Anne Boleyn placed her head on the [ block ] and awaited her execution .	artifact artefact	T
the [ product ] of 2 and 3 is 6	quantity	T
the [ application ] of maximum thrust	action	T
he played [ catch ] with his son in the backyard	game	T
laws limit the [ sale ] of handguns	selling merchandising marketing	T
You could fry up some chicken livers for a tasty treat . — Nah , I do n't like chicken [ liver ] .	variety_meat organs	T
the plains lay just beyond the mountain [ range ]	geological_formation formation	T
Her dress was so short you could nearly see her [ fanny ]	genitalia genital_organ genitals private_parts privates crotch	T
A text file will have a file [ extension ] of .txt .	string	T
the golfer asked for an [ official ] who could give him a ruling	adjudicator	T
Grāmata maksā piecas kronas — the book costs five [ krona ]	Swedish_monetary_unit	T
the [ connection ] between church and state is inescapable	union unification	T
[ enthalpy ] is the amount of energy in a system capable of doing mechanical work	physical_property	T
Get a [ life ] .	being beingness existence	T
he 's in the [ nick ]	prison prison_house	T
a beggar 's [ masquerade ] of wealth	pretense pretence pretending simulation feigning	T
A CPU is a [ component ] of a computer .	part portion	T
a financial [ crunch ]	situation	T
they study the evolution of the [ universe ]	natural_object	T
the ball was still in [ play ]	action activity activeness	T
The applicant now seeks [ leave ] to appeal and , if leave be granted , to appeal against these sentences .	permission	T
a [ wave ] of conservatism in the country led by the hard right	rise	T
Unfortunately , the leading bridesmaid stepped on the bride 's [ train ] as they were walking down the aisle .	piece_of_cloth piece_of_material	T
the whole [ room ] was cheering	gathering assemblage	T
in the [ year ] 1920	time_period period_of_time period	T
he got a good [ fix ] on the target	determination finding	T
I was on a winning [ streak ] until the fourth game , where I was dealt terrible cards .	succession	T
a [ sense ] of security	awareness consciousness cognizance cognisance knowingness	T
[ gravitation ] can not be held responsible for people falling in love "-- Albert Einstein	attraction attractive_force	T
he won the prize for best [ costume ]	attire garb dress	T
the [ scale ] of the model	proportion	T
I did n't have [ time ] to finish	time_period period_of_time period	T
The car 's [ finish ] was so shiny and new .	decorativeness	T
he left school before the end of [ term ]	time_period period_of_time period	T
Common [ sense ] is not so common	sagacity sagaciousness judgment judgement discernment	T
There was n't that much elbow [ room ] in the aircraft .	position spatial_relation	T
can you shed [ light ] on this problem ?	insight brainstorm brainwave	T
the [ ball ] travelled 90 mph on his serve	game_equipment	T
the baby was a [ boy ]	male male_person	T
[ practice ] makes perfect	training preparation grooming	T
the [ floor ] of the pelvis	surface Earth's_surface	T
It is dangerous to look at the beam of a laser while it is in [ operation ] .	medical_procedure	T
he ran away from home to join the [ circus ]	company troupe	T
they handed out the printed [ text ] of the mayor 's speech	matter	T
The boulder came to [ rest ] just behind the house after rolling down the mountain .	inaction inactivity inactiveness	T
A [ reading ] of the current situation .	interpretation	T
My [ hearing ] is n't what it used to be , but I still heard that noise .	exteroception	T
there is not a [ drop ] of pity in that man	small_indefinite_quantity small_indefinite_amount	T
he applied a coat of a clear [ finish ]	decorativeness	T
They improve their product every year ; they export most of their agricultural [ production ] .	creation	T
The hunters found deer [ sign ] at the end of the trail .	clue clew cue	T
the elevators were at the end of the [ hall ]	corridor	T
Launch [ window ] ; window of opportunity	time_period period_of_time period	T
the idea of motion was always to the [ forefront ] of his mind and central to his philosophy	position view perspective	T
his [ claim ] that he was innocent	assertion averment asseveration	T
The [ cycle ] of the seasons , or of the year	time_interval interval	T
the job will take more than an [ hour ]	time_unit unit_of_time	T
A crop circle was made in a corn [ field ] .	tract piece_of_land piece_of_ground parcel_of_land parcel	T
the [ line ] of soldiers advanced with their bayonets fixed	formation	T
they did n't follow our [ lead ]	leadership leading	T
a chauffeur opened the door of the limousine for the grand [ lady ]	woman adult_female	T
Sent via [ post ] ; parcel post	occupation business job line_of_work line	T
` wo n't ' is a [ contraction ] of ` will not '	word	T
His [ bid ] was $ 35,000 .	offer offering	T
the dictionary 's [ coverage ] of standard English is excellent	extent	T
she was granted [ leave ] to speak	permission	T
come in out of the [ cold ]	temperature	T
she made a [ copy ] of the designer dress	representation	T
Philip 's [ dwelling ] fronted on the street . - Alfred Tennyson	housing lodging living_accommodations	T
intellectual [ bankruptcy ]	failure	T
We got into a silly [ quarrel ] about what food to order .	dispute difference difference_of_opinion conflict	T
The boss is gon na give her the [ sack ] today .	termination ending conclusion	T
the [ key ] to development is economic integration	explanation	T
A [ chain ] of mountains	series	T
it brought out his better [ side ]	aspect facet	T
the attraction of the book is precisely its [ narrowness ] of focus	restriction limitation	T
the rear [ part ] of the house	object physical_object	T
Their angry expressions were a clear [ sign ] they did n't want to talk .	clue clew cue	T
impossibility should never be confused with [ improbability ]	uncertainty uncertainness precariousness	T
a lot of people are out of [ work ]	occupation business job line_of_work line	T
the dollar is the United States [ unit ] of currency	definite_quantity	T
The design needs to be [ field ] - tested before we commit to manufacture .	region	T
he dreamed of a home on the [ range ]	tract piece_of_land piece_of_ground parcel_of_land parcel	T
he limited his losses by [ diversification ] of his product line	change	T
he writes with his [ right ] hand but pitches with his left	hand manus mitt paw	T
The ocean was finally at [ rest ] .	inaction inactivity inactiveness	T
there was only one piece of [ furniture ] in the room	furnishing	T
Go easy on him : he is but a [ child ] .	juvenile juvenile_person	T
crop [ rotation ] makes a balanced demand on the fertility of the soil	sequence chronological_sequence succession successiveness chronological_succession	T
after several trials he mixed the [ shade ] of pink that she wanted	color colour coloring colouring	T
his plan of [ attack ] was misguided	conceptualization conceptualisation formulation	T
a smell of chemicals in the [ air ]	gas	T
this [ thing ] has got to end	situation state_of_affairs	T
The best poker players can tell if the opponents have a good hand by looking at their [ expression ] .	countenance visage	T
a [ trial ] of progesterone failed to relieve the pain	experiment experimentation	T
We need to finalise the [ deal ] with Henderson by midnight .	transaction dealing dealings	T
the preface contained an [ acknowledgment ] of those who had helped her	message content subject_matter substance	T
The third link of the silver [ chain ] needs to be resoldered .	series	T
Come this [ way ] and I 'll show you a shortcut .	artifact artefact	T
the [ question ] of disease merits serious discussion	subject topic theme	T
She 's got such a [ gob ] on her – she′s always gossiping about someone or other .	mouth oral_cavity oral_fissure rima_oris	T
Football tickets are expensive at fifty bucks a [ throw ] .	opportunity chance	T
We 've been having a lot of [ rain ] lately .	precipitation downfall	T
he resorted to the [ interception ] of his daughter 's letters	prevention bar	T
the [ price ] of success is hard work	value	T
Respect my [ authority ] !	control	T
the patient recited a [ litany ] of complaints	address speech	T
he was a charter member of the [ movement ]	social_group	T
The [ helm ] of the Commonwealth	leadership leading	T
whatever it was he did n't like it and he was going to let them know by making as loud a [ noise ] as he could	cry outcry call yell shout vociferation	T
[ stabilization ] means that the product can be handled under atmospheric conditions	standardization standardisation normalization normalisation	T
any good golf club will have a [ range ] where you can practice	facility installation	T
Might I beg [ leave ] to accompany you ?	permission	T
he gave the hood a quick [ rub ]	contact physical_contact	T
In summer , it is possible to hike to the [ summit ] of Mt. Shasta .	topographic_point place spot	T
There 's a lot of trash on the [ bed ] of the river .	natural_depression depression	T
If it was n't subsidized , the [ nonprofit ] would be bankrupt .	organization organisation	T
The [ flap ] of a sail ;    the flap of a wing	covering	T
This school is well - known for having teachers of high [ quality ] .	degree grade level	T
Justification is an act of God 's free [ grace ] wherein he pardoneth all our sins . ( the Westminster shorter catechism of 1647 , question 33http://books.google.com / books?id=7gMNAAAAIAAJ&pg = PA683&dq=%22Free+Grace%22&hl = en&ei =- pv_TLz3Hsrf4ga0-ISdCA&sa = X&oi = book_result&ct = result&resnum=1&ved=0CCgQ6AEwAA#v = onepage&q=%22Free%20Grace%22&f = false )	beneficence	T
A dedicated [ line ]	connection connexion connector connecter connective	T
his daily [ run ] keeps him fit	locomotion travel	T
The spaceship came under the [ pull ] of the gas giant .	force	T
thanks to that quack I am a human [ wreck ]	decline declination	T
the [ head ] of the page	top	T
a [ body ] of doctrine	system scheme	T
curled up on the [ foot ] of the bed	bottom	T
She brings a [ wealth ] of knowledge to the project .	financial_condition	T
he has a [ feel ] for animals " or " it 's easy when you get the feel of it	awareness consciousness cognizance cognisance knowingness	T
the [ head ] of the stairs	top	T
Those clouds show little [ sign ] of raining soon .	clue clew cue	T
he presided over the economy during the period of the greatest [ stress ] and danger"- R.J.Samuelson	difficulty	T
the team was off [ form ] last night	ability	T
a good [ sport ]	person individual someone somebody mortal soul	T
it was an old briefcase but it still had a good [ grip ]	appendage	T
( The believers ... those ... ) who abstain from [ sex ]	bodily_process body_process bodily_function activity	T
he has a very complicated [ love ] life	sexual_activity sexual_practice sex sex_activity	T
stay after [ school ]	time_period period_of_time period	T
a [ trump ] can take a trick even when a card of a different suit is led	suit	T
A building [ lot ] in a city	tract piece_of_land piece_of_ground parcel_of_land parcel	T
a [ unit ] of wheat is a bushel	definite_quantity	T
the book had an important [ impact ] on my thinking	consequence effect outcome result event issue upshot	T
there was not a [ scrap ] left	piece	T
in an [ optimization ] problem we seek values of the variables that lead to an optimal value of the function that is to be optimized	improvement	T
it is part of the [ fabric ] of society	structure	T
The world economy had a rough [ patch ] in the 1930s .	time	T
insure the [ safety ] of the children	condition status	T
[ fire ] was one of our ancestors ' first discoveries	combustion burning	T
the [ difference ] in her is amazing	change	T
The world 's foremost [ authority ] on orangutans	administrative_unit administrative_body	T
the moon 's [ disk ] hung in a cloudless sky	round_shape	T
You have no [ right ] to go through my personal diary .	abstraction abstract	T
he went out to have a [ look ]	sensing perception	T
I do n't like the [ look ] of the new design .	appearance visual_aspect	T
I could see the [ roof ] of the bear 's mouth	covering natural_covering cover	T
is there any [ post ] for me ?	collection aggregation accumulation assemblage	T
a [ place ] in my heart	cognition knowledge noesis	T
there is a [ demand ] for jobs	condition status	T
[ air ] pollution	gas	T
There is no better time than [ now ] .	present nowadays	T
a ranch [ hand ]	laborer manual_laborer labourer jack	T
he was a successful pianist in his [ day ]	era epoch	T
a [ sense ] of danger	awareness consciousness cognizance cognisance knowingness	T
Give him his [ due ] — he is a good actor .	right	T
The judge leniently granted a [ sentence ] with no hard time .     He is not living at home because he is doing time .	term	T
David Beckham 's first [ appearance ] with the LA Galaxy at Giants Stadium against the New York Red Bulls last night drew a crowd of 66237 .	arrival	T
the [ edge ] of the leaf is wavy	limit demarcation demarcation_line	T
the book [ wallah ]	worker	T
she invented a potato [ peeler ]	device	T
the emerging buds were a sure sign of [ spring ]	season time_of_year	T
Many readers find the first [ book ] of A Tale of Two Cities to be confusing .	section subdivision	T
the [ mother ] of three children	parent	T
He is the Republican [ boss ] in Kentucky .	politician politico pol political_leader	T
That mechanic 's a [ bum ] - he could n't fix a yo - yo .	nonworker	T
When was the last [ time ] we went out ? I do n't remember .	case instance example	T
Her features had a delicate [ cast ] to them .	appearance visual_aspect	T
This product of last month 's quality standards committee is quite good , even though the [ process ] was flawed .	physical_entity	T
it is their [ practice ] to give annual raises	activity	T
The match ended in their first [ loss ] of the season .	disadvantage	T
the [ voice ] of experience	communication	T
This diamond comes from a [ mine ] in South Africa .	excavation	T
he rode into the [ mouth ] of the canyon	opening gap	T
he started looking for a gas [ station ]	facility installation	T
the season 's [ opener ] was a game against the Yankees	start	T
the [ end ] of the pier	extremity	T
they entertained on a grand [ scale ]	magnitude_relation quantitative_relation	T
they 're just country [ folk ]	people	T
it was Bernhardt 's last [ appearance ] in America	arrival	T
the water 's [ edge ]	limit demarcation demarcation_line	T
You can visit me in the [ spring ] , when the weather is bearable .	season time_of_year	T
The [ visibility ] from that angle was good .	perceptibility	T
he paid all his bills by [ check ]	draft bill_of_exchange order_of_payment	T
Dog is a [ hyponym ] of animal .	word	T
the [ face ] of the city is changing	appearance visual_aspect	T
24 hours of TV coverage of the US election verged on [ overkill ] .	effort elbow_grease exertion travail sweat	T
Unremitting [ pursuit ] of wealth does n't bring happiness , particularly if successful .	motion movement move	T
Given a Boolean A , " A OR ( NOT A ) " is a [ tautology ] .	truth true_statement	T
They came together in a chance [ meeting ] on the way home from work .	gathering assemblage	T
A [ leak ] in a gas pipe	discharge outpouring run	T
he had a pain in his [ side ]	area region	T
The truck overturned while carrying a full [ load ] of oil .	indefinite_quantity	T
the [ song ] of the wind	sound	T
change per [ unit ] volume	definite_quantity	T
Pour me a fresh beer ; this one has no [ head ] .	foam froth	T
he lived a long and happy [ life ]	time_period period_of_time period	T
the town debated the purification of the [ water ] supply	facility installation	T
all the [ world ] loves a lover	group grouping	T
the [ reticulation ] of a leaf	network	T
the [ pull ] of the moon	force	T
Any painter can benefit from the [ presence ] of a live model from which to draw .	being beingness existence	T
A [ hurl ] of abuse .	throw	T
he removed the [ top ] of the carton	covering	T
A reduction in the assessment per [ head ] of sheep	domestic_animal domesticated_animal	T
a [ sense ] of self	awareness consciousness cognizance cognisance knowingness	T
before they publish any book they try to determine the size of the [ market ] for it	class stratum social_class socio-economic_class	T
The maths problem is a real [ snorter ] , is n't it ?	difficulty	T
the winning [ score ] came with less than a minute left to play	success	T
there was a shocked [ silence ]	condition status	T
that 's the [ way ] it is	condition status	T
Mark 's health was of great [ concern ] to Connie .     The recent events in London are of no concern to most people in Australia .	interest involvement	T
this is the [ one ] I ordered	unit	T
the [ chain ] of command	series	T
he works at a great [ rate ]	temporal_property	T
My [ neighbour ] is very irritable and grumpy at times .	person individual someone somebody mortal soul	T
the wee small [ voice ] of conscience	communication	T
The incarnation is a basic [ doctrine ] of classical Christianity .	belief	T
he bought his brother 's [ business ]	enterprise	T
the lawyer questioned the [ truth ] of my account	quality	T
he did a [ stretch ] in the federal penitentiary	duration continuance	T
it was his [ area ] of specialization	topic subject issue matter	T
Hypnosis is a peculiar [ condition ] of the nervous system .     Steps were taken to ameliorate the condition of slavery .     Security is defined as the condition of not being threatened .     Aging is a condition over which we are powerless .	state	T
a Cadillac makes a [ statement ] about who you are	message content subject_matter substance	T
what [ position ] does he play ?	role	T
a [ war ] of wits	conflict struggle battle	T
I gave the waiter my [ order ]	request asking	T
the gene [ inactivation ] system	natural_process natural_action action activity	T
I had no further [ trade ] with him	transaction dealing dealings	T
he turned the box over to examine the bottom [ side ]	surface	T
The Welsh government claims that Cardiff is Europe 's youngest [ capital ] .	seat	T
they polled their [ membership ]	body	T
He managed to show a bold [ face ] despite his embarrassment .	appearance visual_aspect	T
Space [ travel ]	motion movement move	T
This is my [ house ] and my family 's ancestral home .	building edifice	T
the subjects ' [ set ] led them to solve problems the familiar way and to overlook the simpler solution	cognitive_state state_of_mind	T
the mayor threw out the first [ ball ]	game_equipment	T
The house gave me a [ feeling ] of dread .	state	T
This Chinese [ year ] is the year of the Rooster .	time_period period_of_time period	T
a congregation is a [ vehicle ] of group identity	medium	T
dew dripped from the [ face ] of the leaf	surface	T
he detected a [ note ] of sarcasm	air aura atmosphere	T
a serious [ loss ] of business	decline diminution	T
it took more than half my [ time ]	time_period period_of_time period	T
a heroic [ figure ]	impression effect	T
The [ part ] of his hair was slightly to the left .	line	T
the [ didacticism ] expected in books for the young	communication	T
the [ quality ] of students has risen	degree grade level	T
The photo is a little dark in that [ area ] .	extent	T
The [ apparition ] of Lawyer Clippurse occasioned much speculation in that portion of the world . – Sir W. Scott .	appearance	T
she has a heart of [ gold ]	invaluableness preciousness pricelessness valuableness	T
they were disappointed by the poor returns on their stock [ portfolio ]	list listing	T
recent federal [ action ] undermined the segregationist position	group_action	T
he stuck his [ head ] out the window	external_body_part	T
that kid is a terrible [ pain ]	unpleasant_person disagreeable_person	T
he took a deep [ breath ] and dived into the pool	bodily_process body_process bodily_function activity	T
the cooling [ touch ] of the night air	contact impinging striking	T
Can I have a [ dozen ] eggs , please ?	large_integer	T
as a result of the [ blowout ] we lost all the lights	malfunction	T
hardly enough elbow [ room ] to turn around	position spatial_relation	T
She had a [ smile ] on her face .	facial_expression facial_gesture	T
he was surprised by the [ absence ] of any explanation	lack deficiency want	T
How much [ furniture ] did they leave behind ?	furnishing	T
I can not think it a [ hardship ] that more indulgence is allowed to men than to women"- James Boswell	misfortune bad_luck	T
Mayonnaise is an [ emulsion ] where egg is used to keep oil and water mixed .	colloid	T
Our children attend a public [ school ] in our neighborhood .	educational_institution	T
the gardener planted a [ bed ] of roses	plot plot_of_land plot_of_ground patch	T
God 's [ grace ] is manifested in the salvation of sinners	beneficence	T
the [ object ] of my affection	content cognitive_content mental_object	T
they had stock [ footage ] of lightning , tornados , and hurricanes	film photographic_film	T
Many sunken ships rest on the ocean [ floor ] .	surface Earth's_surface	T
To apply for the position , complete the application [ form ] .	document written_document papers	T
they drew up a six - step [ plan ]	idea thought	T
he recalled the [ experience ] vividly	content cognitive_content mental_object	T
He did n't want his pockets to bulge so he was walking around with all his [ stuff ] in his hands .	object physical_object	T
the reason that the agency is doomed to inaction has something to do with the FBI [ culture ]	attitude mental_attitude	T
it was a bum [ rap ]	reproach	T
By [ law ] , one is not allowed to own a wallaby in New York City .	collection aggregation accumulation assemblage	T
200 [ head ] of cattle and 50 head of horses	domestic_animal domesticated_animal	T
his [ conflict ] of interest made him ineligible for the post	state	T
barbecue over an open [ fire ]	fuel	T
you are in no [ danger ]	condition status	T
they stopped selling in exact sizes in order to reduce [ inventory ]	merchandise ware product	T
he recorded the spoken [ language ] of the streets	auditory_communication	T
in careful usage the noun [ enormity ] is not used to express the idea of great size	enormousness grandness greatness immenseness immensity sizeableness vastness wideness	T
The [ shortness ] of a stubby pencil	lowness	T
So that 's fifteen - [ love ] to Kournikova .	score	T
A [ block ] of stone .	artifact artefact	T
his coin collection included the complete [ series ] of Indian - head pennies	group grouping	T
sand of a fine [ grain ]	constitution composition physical_composition makeup make-up	T
Their [ assumption ] of his guilt disqualified them from jury duty .	hypothesis possibility theory	T
it is [ time ] to go	moment minute second instant	T
He can have the [ run ] of the house .	liberty	T
he wrote a letter of [ apology ] to the hostess	acknowledgment acknowledgement	T
the [ hum ] of distant traffic	noise	T
a political system with no [ place ] for the less prominent groups	cognition knowledge noesis	T
political [ convention ]	meeting group_meeting	T
it is not work but [ worry ] that kills	anxiety	T
We hiked through the Andes mountain [ range ] .	geological_formation formation	T
Sorry , girls , I suck [ dick ] .	penis phallus member	T
his display of [ foulness ] deserved severe punishment	iniquity wickedness darkness dark	T
We 're expecting a large [ party ] from the London office .	social_gathering social_affair	T
The pit [ floor ] showed where a ring of post holes had been .	surface Earth's_surface	T
I am not of your [ persuasion ]	belief	T
the [ appointment ] had to be approved by the whole committee	decision determination conclusion	T
a prison [ term ]	time_period period_of_time period	T
he played [ baseball ] in high school	ball_game ballgame	T
my [ neighborhood ] voted for Bush	community	T
the [ poison ] of fascism	destructiveness	T
A peasant is not allowed to fall in love with a lady of [ quality ] .	social_station social_status social_rank rank	T
the simultaneous [ optimization ] of growth and profitability	improvement	T
US [ date ] : 05/24/08 = Tuesday , May 24th , 2008 . UK date : 24/05/08 = Tuesday 24th May 2008 .	calendar_day civil_day	T
the doctor recommended regular [ exercise ]	effort elbow_grease exertion travail sweat	T
he threw a [ rock ] at me	natural_object	T
a filming [ session ]	meeting coming_together	T
Napoleon III was an [ echo ] of the mighty Emperor but an infinitely better man	analogue analog parallel	T
you do n't have the [ stuff ] to be a United States Marine	quality	T
he followed on [ foot ]	walk	T
At five years of age this [ head ] of cattle is worth perhaps $ 40	domestic_animal domesticated_animal	T
The medical resident finished a two - week [ rotation ] in pediatrics and began one in orthopaedics .	sequence chronological_sequence succession successiveness chronological_succession	T
spiritual [ bankruptcy ]	failure	T
an [ indication ] of foul play	communication	T
There is a hurricane in the [ vicinity ] of the Bahamas .	section	T
Tow is flax with short [ staple ] .	natural_fiber natural_fibre	T
He celebrated after the [ sale ] of company .	agreement understanding	T
the enemy offered little [ resistance ]	military_action action	T
The " [ war ] on terror " is a campaign against terrorist crime .	campaign cause crusade drive movement effort	T
exercise gave him a good [ stomach ] for dinner	appetite appetency appetence	T
Does n't that [ patch ] of clouds looks like a bunny ?	time	T
it ended on a sour [ note ]	air aura atmosphere	T
the whole [ school ] turned out for the game	educational_institution	T
the duties of citizenship are lost sight of in the [ wilderness ] of interests of individuals and groups	profusion profuseness richness cornucopia	T
They are having a clearance [ sale ] : 50 % off .	occasion	T
the [ weakness ] of the span was overlooked until it collapsed	property	T
his dreams all turned to [ smoke ]	insubstantiality	T
the clone was a [ copy ] of its ancestor	representation	T
bad [ luck ] caused his downfall	phenomenon	T
they had a nice [ stay ] in Paris	act deed human_action human_activity	T
Bernoulli 's [ principle ] ;     The http://en.wikipedia.org/wiki/Pauli_exclusion_principle Pauli Exclusion Principle prevents two fermions from occupying the same state .     The principle of the internal combustion engine	law natural_law	T
A [ grain ] of sand	atom molecule particle corpuscle mote speck	T
In all [ likelihood ] the meeting will be cancelled .	probability	T
He gave up on [ life ] .	being beingness existence	T
We saw a two - act [ play ] in the theatre .	dramatic_composition dramatic_work	T
A solid [ border ] around a table of figures	edge	T
the [ practice ] of the law	use usage utilization utilisation employment exercise	T
you would be a [ dingbat ] even to try it	simpleton simple	T
The village [ fool ] threw his own shoes down the well .	simpleton simple	T
A [ procession ] of mourners ; the Lord Mayor 's procession	collection aggregation accumulation assemblage	T
A [ treatment ] or cure is applied after a medical problem has already started .	care attention aid tending	T
the only city of any [ size ] in that area	magnitude	T
it worked up to right [ now ]	present nowadays	T
How great thou [ art ] !	superior_skill	T
they set out on their [ return ] to the base camp	motion movement move	T
frustrated by the [ narrowness ] of people 's horizons	restriction limitation	T
[ demobilization ] of factories	social_control	T
Piecas kronas — five [ krona ]	Swedish_monetary_unit	T
the United Nations must have the power to propose and organize [ action ] without being hobbled by irrelevant issues	group_action	T
I 'll just go to the [ lumberyard ] and buy some more two by fours so we can finish building this .	workplace work	T
It 's common [ sense ] not to put metal objects in a microwave oven .	sagacity sagaciousness judgment judgement discernment	T
He has a sinister [ smile ] .	facial_expression facial_gesture	T
in a weak financial [ state ]	attribute	T
the Times is not the [ voice ] of New York	means agency way	T
A good teacher is essential for a good [ education ] .	activity	T
Can I buy you a [ drink ] ?	helping portion serving	T
the car pulled off onto the [ shoulder ]	edge	T
law and [ order ]	state	T
She has a pretty [ face ] .	external_body_part	T
his stories were too susceptible to [ ulteriority ]	quality	T
That tree was hit by [ lightning ] .	flash	T
caught in the [ mire ] of poverty	difficulty	T
it should arrive any [ day ] now	time	T
he worked for price [ stabilization ] for farm products	standardization standardisation normalization normalisation	T
You were in the courtroom . What is your [ reaction ] ?	bodily_process body_process bodily_function activity	T
.. and [ neap ] tides ( tides that occur during the first and third quarters of the moon and that have the least difference between high and low tides ) , ... — Richard M. Schlenker and Sarah J. Yoshida , " Developing Science Activities " , Science Activities , Vol . 32 Issue 2 , p34 , 7p , 3 charts , Summer , 1995	high_tide high_water highwater	T
They were pleased about their [ move ] to the country .	change	T
The teaching consists of theory lessons and [ case ] studies .	circumstance	T
he came to a bad [ end ]	state	T
[ room ] to pass	position spatial_relation	T
This led to an unfortunate [ chain ] of events .	series	T
he got a [ refill ] of his prescription	prescription_drug prescription prescription_medicine ethical_drug	T
city [ life ]	being beingness existence	T
When I last tried to eat strawberries I had a terrible allergic [ reaction ] .	bodily_process body_process bodily_function activity	T
A person makes his [ appearance ] as an historian , an artist , or an orator .	arrival	T
social [ life ]	being beingness existence	T
he had a religious [ experience ]	content cognitive_content mental_object	T
I envied his rapid [ buildup ] of assets	accumulation accrual accruement	T
he borrowed a large [ sum ]	assets	T
The iPhone [ application ] VR+ connects to major social networks .	program programme computer_program computer_programme	T
I love [ beer ] but I know it is bad for you .	brew brewage	T
the distinctive [ ring ] of the church bell	sound	T
it was a busy [ day ] on the stock exchange	work_time	T
they fought to regain the lost [ ground ]	military_position position	T
My headache has no [ connection ] with me going out last night .	union unification	T
the [ ringing ] of the telephone	sound	T
he altered the [ complexion ] of his times	point_of_view viewpoint stand standpoint	T
he 's a meticulous [ dresser ]	person individual someone somebody mortal soul	T
the [ grocery ] store included a meat market	marketplace market_place mart market	T
a [ notice ] of sale	announcement promulgation	T
The right reader of a good poem can tell the moment it strikes him that he has taken an immortal [ wound ] -- that he will never get over it "-- Robert Frost	distress hurt suffering	T
he gave the brat a good [ spanking ]	discipline correction	T
earthquakes originate far below the [ surface ]	layer	T
They made an [ appointment ] to meet at six .	meeting get_together	T
he was in the [ employ ] of the city	state	T
when you have a [ monopoly ] you can ask any price you like	market marketplace market_place	T
he had become an [ institution ] in the theater	custom tradition	T
the deterrent [ power ] of nuclear weapons	quality	T
it was about 500 square feet in [ area ]	extent	T
The [ death ] of my grandmother saddened the whole family .	change alteration modification	T
a [ set ] of golf clubs	collection aggregation accumulation assemblage	T
There are some who question the [ scale ] of our ambitions .	proportion	T
Hey , buddy , you got a [ light ] ?	device	T
that is enough for the [ present ]	time	T
I have the [ authority ] to penalise the staff in my department , but not the authority to sack them .	control	T
every artist needs an [ audience ]	multitude masses mass hoi_polloi people the_great_unwashed	T
the rate of [ unemployment ] is an indicator of the health of an economy	state	T
an [ entreaty ] to stop the fighting	request asking	T
the [ formation ] of crystals	natural_process natural_action action activity	T
a [ sense ] of happiness	awareness consciousness cognizance cognisance knowingness	T
a time [ period ] of 30 years	fundamental_quantity fundamental_measure	T
the immigrants spoke an odd [ dialect ] of English	non-standard_speech	T
Charm is his most endearing [ property ] .	attribute	T
I got some great bargains at their annual [ sale ]	occasion	T
he has the [ one ] but will need a two and three to go with it	digit figure	T
he works for the United States [ mail ] service	communication communicating	T
she called it a [ day ] and went to bed	work_time	T
While being impulsive can be great for artists , it is not a desirable [ quality ] for engineers .	attribute	T
he invented a technique to determine the [ sequence ] of base pairs in DNA	series	T
He came out of the coal [ mine ] with a face covered in black .	excavation	T
the motor was out of [ commission ]	operation	T
a [ component ] or constituent element of a system	part portion	T
he felt as if his whole [ body ] were on fire	natural_object	T
he placed a phone [ call ] to London	telephone telephony	T
I could n't believe my [ luck ] when I found a fifty dollar bill on the street .	phenomenon	T
He set his e - mail message 's [ priority ] to high .	high_status	T
I caught him with a solid [ shot ] to the chin	blow	T
deep in her breast lives the silent [ wound ]	distress hurt suffering	T
he jumped into the [ drink ] and had to be rescued	body_of_water water	T
This [ trombone ] is very expensive .	brass brass_instrument	T
A [ tautology ] can be verified by constructing a truth tree for its negation : if all of the leaf nodes of such truth tree end in X 's , then the original ( pre - negated ) formula is a tautology .	truth true_statement	T
the president no longer has the [ support ] of his own party	aid assist assistance help	T
the government tried to accelerate the [ commercialization ] of this development	exploitation development	T
he overstepped his [ place ]	social_station social_status social_rank rank	T
the assembly line was on a 12-hour [ run ]	time_period period_of_time period	T
A [ leak ] in a roof	discharge outpouring run	T
The new law will come into [ effect ] on the first day of next year .	validity validness	T
the architect left [ space ] in front of the building	amorphous_shape	T
The store is huge , occupying an entire city [ block ] .	area country	T
A roller [ cot ] ( the clothing of a drawing roller in a spinning frame )	sheath	T
a [ drain ] on resources	depletion	T
a small mom - and - pop [ business ]	enterprise	T
As a Greek numeral , [ iota ] represents ten .	letter letter_of_the_alphabet alphabetic_character	T
in the [ day ] of the dinosaurs	era epoch	T
he checked the [ direction ] and velocity of the wind	position spatial_relation	T
This building used to be a [ church ] before being converted into a library .	place_of_worship house_of_prayer house_of_God house_of_worship	T
England coach Sven Göran Eriksson hailed midfielder David Beckham as possibly the best [ passer ] in the world . - http://news.bbc.co.uk/sport1/hi/football/world_cup_2002/1354920.stm BBC Sport - Eriksson salutes Beckham brilliance	student pupil educatee	T
the [ machinery ] of command labored and brought forth an order	system scheme	T
there was a [ drop ] in pressure in the pulmonary artery	decrease decrement	T
they collected and cut their own [ firewood ]	fuel	T
That guy keeps interrupting the concert . Throw the [ bum ] out !	nonworker	T
Which [ side ] of the tray shall I put it on ?	area region	T
" A is a [ hyponym ] of B " means that " A is a type of B. "	word	T
a lazy [ bum ]	nonworker	T
There should n't be more than two [ dozen ] Christmas cards left to write .	large_integer	T
[ life ] depends on many chemical and physical processes	being beingness existence	T
Place a [ check ] by the things you have done .	mark	T
he spoke in a nervous [ tone ] of voice	manner_of_speaking speech delivery	T
he uttered harsh [ language ]	auditory_communication	T
the [ art ] of conversation	superior_skill	T
he looked for books with the word ` jazz ' in the [ title ]	name	T
To fall off a [ point ]	direction	T
there was a certain [ woodenness ] in his replies	awkwardness clumsiness gracelessness stiffness	T
Unauthorized [ reproduction ] of this article is prohibited .	copying	T
The gift of [ language ]	communication	T
they improve their [ product ] every year	creation	T
the Cotswolds were once at the [ forefront ] of woollen manufacturing in England	position view perspective	T
He was arrested and taken down to Sun Hill [ nick ] police station to be charged .	prison prison_house	T
a [ ball ] of fire	sphere	T
the family owned a large [ estate ] on Long Island	real_property real_estate realty immovable	T
he drank a [ cup ] of coffee	containerful	T
by no [ stretch ] of the imagination	extension	T
put your books on [ top ] of the desk	side face	T
he planted a [ field ] of wheat	tract piece_of_land piece_of_ground parcel_of_land parcel	T
The noblemen visited the queen in her [ court ] .	residence	T
may the [ force ] be with you	causal_agent cause causal_agency	T
he heard the phone ringing but did n't want to take the [ call ]	telephone telephony	T
I 've always had a [ liking ] for reading	feeling	T
He passed all the exams with [ ease ] .	quality	T
A book about a time machine that can transport people back into the [ past ]	time	T
To say crossing the street was brave was quite a [ stretch ] .	motion movement move motility	T
she made the [ boy ] brush his teeth every night	male male_person	T
I could n't get his words out of my [ head ]	cognition knowledge noesis	T
A peach [ stone ]	pericarp seed_vessel	T
the plane was just a [ speck ] in the sky	spot speckle dapple patch fleck maculation	T
the [ time ] is 10 o'clock	reading meter_reading indication	T
I made many mistakes in my [ youth ] , but learned from them all .	time_of_life	T
a good [ ear ] for pitch	hearing audition auditory_sense sense_of_hearing auditory_modality	T
Would you be a dear and get me a cup of [ tea ] , please ?	herb	T
the [ number ] of parameters is small	amount	T
It just wo n't make much of a [ difference ] to anyone .	change	T
The annual report has been my [ baby ] since September .	undertaking project task labor	T
The [ move ] into my fiancé 's house took two long days .	change	T
the [ war ] against crime	campaign cause crusade drive movement effort	T
no escape from the [ ghetto ] of the typing pool	life	T
the [ cold ] helped clear his head	temperature	T
a bald [ spot ]	marking	T
a [ length ] of tubing	section segment	T
book [ fair ]	gathering assemblage	T
The band returned to the [ stage ] to play an encore .	platform	T
show me where the [ business ] was today	business_activity commercial_activity	T
If you do n't give me a [ reason ] to go with you , I wo n't .	rational_motive	T
I lost my locket in this [ patch ] of grass here .	time	T
his [ nomination ] was hotly protested	condition status	T
He was a rotund , jolly man with a [ twinkle ] in his eye .	expression look aspect facial_expression face	T
for your [ sake ]	benefit welfare	T
[ cold ] is a vasoconstrictor	temperature	T
he stood on the [ right ]	position place	T
the surface had a greasy [ feeling ]	perception	T
[ grade ] A milk	evaluation valuation rating	T
renewed jitters in the wake of a [ blip ] in retail sales	shock blow	T
toe the [ line ]	conformity conformation compliance abidance	T
a gossip [ session ]	meeting coming_together	T
We had a wonderful [ time ] at the party .	experience	T
We walked with a quick , even [ rhythm ] .	musical_time	T
a biochemical [ profile ] of blood	chart	T
she 's an elegant [ dresser ]	person individual someone somebody mortal soul	T
the [ change ] was intended to increase sales	happening occurrence occurrent natural_event	T
It is the usual [ practice ] of employees there to wear neckties only when meeting with customers .	activity	T
she bought a lovely [ piece ] of china	item	T
the house was filled with [ company ] when I arrived	social_gathering social_affair	T
the [ production ] of white blood cells	act deed human_action human_activity	T
The teenager could n't bear the [ shame ] of introducing his parents .	dishonor dishonour	T
They come from a faraway [ land ] .	object physical_object	T
The [ question ] of seniority will be discussed at the meeting .	subject topic theme	T
their quarterback was a good [ scrambler ]	mover	T
Iron fillings drawn by the [ pull ] of a magnet	force	T
the machine is now in working [ order ]	condition status	T
my horse lost the race by a [ nose ]	small_indefinite_quantity small_indefinite_amount	T
at a [ distance ] of ten years he had forgotten many of the details	point point_in_time	T
they say [ luck ] is a lady	phenomenon	T
she has a [ thing ] about him	feeling	T
the movie demanded a dramatic [ canvas ] of sound	setting background scope	T
The present [ ministry ] of the Holy Spirit	employment work	T
the Japanese were active last week on the diplomatic [ front ]	sphere domain area orbit field arena	T
They agreed to see each other at the bus [ stop ] .	topographic_point place spot	T
the collar has a [ tab ] with a button hole	strip slip	T
campaigning in his own [ behalf ]	sake interest	T
The centimetre is a [ unit ] of length .	definite_quantity	T
any line joining two points on a [ plane ] lies wholly on that plane	shape form	T
he was here for a little [ while ]	time	T
in the [ interest ] of safety	benefit welfare	T
his horse won by a [ head ]	linear_unit linear_measure	T
in the [ black ] of night	dark darkness	T
he used a piece of [ tape ] for a belt	strip slip	T
he gave his [ word ]	promise	T
the word is a basic linguistic [ unit ]	part portion component_part component constituent	T
he had a [ drop ] too much to drink	small_indefinite_quantity small_indefinite_amount	T
they measured the station 's signal [ strength ]	magnitude	T
the new line of cars will soon be on [ sale ]	merchantability	T
She wanted to wipe him off the [ face ] of the earth .	surface	T
His friend 's opinion had an [ impact ] on his decision .	consequence effect outcome result event issue upshot	T
wage [ stabilization ] is necessary for industrial peace	standardization standardisation normalization normalisation	T
the slow [ development ] of her skill as a writer	process physical_process	T
there 's no place like [ home ]	environment	T
I did n't have a good [ deal ] all evening .	collection aggregation accumulation assemblage	T
The lawyer took a [ cut ] of the profits .	share portion part percentage	T
The [ meaning ] of life	message content subject_matter substance	T
She 's got a perfect [ smile ] .	facial_expression facial_gesture	T
When is your [ baby ] due ?	young_mammal	T
Who 's got [ dibs ] on the chips ?	claim	T
the wall had a smooth [ texture ]	tactile_property feel	T
after that [ day ] she never trusted him again	time	T
A mountain [ pass ]	location	T
it was a package [ deal ]	transaction dealing dealings	T
Under - five [ mortality ] rate is the probability per 1,000 that a newborn baby will die before reaching age five , if subject to current age - specific mortality rates .	rate	T
a [ patch ] of clouds	marking	T
Please turn down the [ volume ] on the stereo .	sound_property	T
Would you like some [ tea ] ?	herb	T
The product is undergoing a [ change ] in order to improve it .	happening occurrence occurrent natural_event	T
to my immense [ gratification ] he arrived on time	emotional_state spirit	T
The green [ party ] took 12 % of the vote .	organization organisation	T
Could you please scratch my [ back ] ?	body_part	T
Put on your [ swimsuit ] and let 's go for a swim .	garment	T
* That would fall under the [ rubric ] of things we can ignore for now .	category	T
the [ recognition ] of the Rio Grande as a boundary between Mexico and the United States	credence acceptance	T
They have no [ monopoly ] on intelligence	dominance ascendance ascendence ascendancy ascendency control	T
Get your [ butt ] to the car .	body_part	T
he never left my [ side ]	region part	T
He was a member of a special police [ unit ] .	part portion component_part component constituent	T
I 'm going to have a quick [ wash ] before coming to bed .	soil_erosion	T
world [ fair ]	gathering assemblage	T
To attain ( or to reach ) [ proficiency ]	competence competency	T
I had a [ brush ] with danger on my way to work	contact	T
there is an [ example ] on page 10	information	T
the [ job ] of repairing the engine took several hours	duty	T
an [ air ] of mystery	quality	T
she hates me , that 's about the [ size ] of it	situation state_of_affairs	T
the outdoor [ world ]	part piece	T
they tested his ability to locate objects in [ space ]	attribute	T
swimming in the [ buff ]	skin tegument cutis	T
he ordered a second [ round ]	helping portion serving	T
The old house served as a [ dwelling ] for Albert .	housing lodging living_accommodations	T
he believed all the Marxist [ dogma ]	doctrine philosophy philosophical_system school_of_thought ism	T
a [ wall ] of prejudice	object physical_object	T
Chief of Staff is the second - highest [ position ] in the army .	state	T
his [ plundering ] of the great authors	aggression hostility	T
200 [ head ] of cattle	domestic_animal domesticated_animal	T
The answer to the comprehension question can be found in the third [ line ] of the accompanying text .	text textual_matter	T
I used [ tact ] when I told my fat uncle that his extra weight made him look better .	consideration considerateness thoughtfulness	T
A right angle is a ninety [ degree ] angle .	angular_unit	T
put the flag back in the [ cup ]	hole	T
A [ leak ] in a boat	discharge outpouring run	T
the cast stood in [ line ] for the curtain call	formation	T
three passengers were killed in the [ collision ]	accident	T
Pittsburgh is located at the [ confluence ] of the Allegheny and Monongahela rivers	geographic_point geographical_point	T
he awoke with a [ start ]	reflex reflex_response reflex_action instinctive_reflex innate_reflex inborn_reflex unconditioned_reflex physiological_reaction	T
there was a small [ opening ] between the trees	space	T
His grandfather was in the Pacific [ theater ] during the war .	region	T
Let 's take a five - minute [ break ] .	pause	T
Papīra [ krona ] — paper krona ( i.e. , bills , banknotes )	Swedish_monetary_unit	T
The [ grip ] of a sword	appendage	T
the melon had a delicious [ taste ]	sensation esthesis aesthesis sense_experience sense_impression sense_datum	T
a disk drive contains a [ microprocessor ] to handle the internal functions of the drive	chip microchip micro_chip silicon_chip microprocessor_chip	T
did you see [ today ] 's newspaper ?	day twenty-four_hours twenty-four_hour_period 24-hour_interval solar_day mean_solar_day	T
he got into a terrible [ fix ]	difficulty	T
estimates of the city 's loss on that [ job ] ranged as high as a million dollars	duty	T
the [ trend ] of the stock market	direction way	T
he broke the [ point ] of his pencil	end terminal	T
the [ mercury ] was falling rapidly	temperature	T
In a small number of horses , muscle [ weakness ] may progress to paralysis .	misfortune bad_luck tough_luck ill_luck	T
emotion caused a [ constriction ] of his throat	feeling	T
she felt she had to get out of the [ house ]	building edifice	T
they divorced after the [ birth ] of the child	beginning commencement first outset get-go start kickoff starting_time showtime offset	T
[ adultery ] is often cited as grounds for divorce	extramarital_sex free_love	T
how many lines of [ communication ] can there be among four people ?	connection connexion connectedness	T
Those opposing the building plans were in the [ majority ] , so the building project was canceled .	relative_quantity	T
in [ line ] with	conformity conformation compliance abidance	T
I did n't hold a good [ hand ] all evening	collection aggregation accumulation assemblage	T
the [ gravitation ] between two bodies is proportional to the product of their masses and inversely proportional to the square of the distance between them	attraction attractive_force	T
they gave him emotional [ support ] during difficult times	activity	T
I did n't have any coins to pay with , so I used a [ note ] .	paper_money folding_money paper_currency	T
The sudden [ apparition ] of the Spaniards . – William H. Prescott .	appearance	T
It is beyond the [ horizon ] of present knowledge	scope range reach orbit compass ambit	T
a [ formation ] of planes	arrangement	T
It just wo n't make much [ difference ] to me .	change	T
she was the [ picture ] of despair	typification exemplification	T
a mere [ ribbon ] of land	object physical_object	T
A left [ identity ] if I * x = x for any x in the structure	operator	T
a [ stick ] of dynamite	implement	T
the [ time ] of year for planting	time_period period_of_time period	T
he grew up in a good Christian [ home ]	environment	T
increasing [ recognition ] that diabetes frequently coexists with other chronic diseases	understanding apprehension discernment savvy	T
pull the [ tab ] to open the can	strip slip	T
a [ system ] generating hydrogen peroxide	matter	T
if you persist in that [ course ] you will surely fail	action	T
he expects to find in us the common honesty and [ integrity ] of men of business	honesty honestness	T
The love of money is the [ root ] of all evil .	point	T
Copy from one , it 's [ plagiarism ] . Copy from two , it 's research .	copyright_infringement infringement_of_copyright	T
he prefers shoes of Italian [ derivation ]	beginning origin root rootage source	T
the [ floor ] of the cave	surface Earth's_surface	T
an [ affinity ] for politics	attraction attractiveness	T
her [ speech ] was barren of southernisms	expressive_style style	T
Admission is three dollars a [ head ] .	individual	T
The [ letter ] of a room	owner proprietor	T
" Our government proposes the [ moralization ] of public functions and the end of impunity for government functionaries and for individuals who violate the law and steal from the people , " — Nicanor Duarte Frutos , President of Paraguay , quoted in the http://articles.latimes.com/2004/apr/04/world/fg-smokes4 Los Angeles Times .	reform	T
He arrived five minutes late , but to his [ credit ] he did work an extra ten minutes at the end of his shift .	approval commendation	T
A [ grain ] of salt	atom molecule particle corpuscle mote speck	T
he whispered a [ spell ] as he moved his hands	speech speech_communication spoken_communication spoken_language language voice_communication oral_communication	T
when bending the elbow the biceps are the [ agonist ]	antagonistic_muscle	T
a racially integrated [ business ] concern	enterprise	T
I had a look in the [ mirror ] to see if the blood had come off my face .	reflector	T
he got a [ refill ] for his notebook	merchandise ware product	T
The bus on the Cherry Street [ run ] is always crowded .	trip	T
he attributes the disappointing results to [ softness ] in the economy	economic_condition	T
a hormonal [ imbalance ]	disequilibrium	T
she was famous as an [ interpreter ] of Shakespearean roles	person individual someone somebody mortal soul	T
he wore a jock strap with a metal [ cup ]	concave_shape concavity incurvation incurvature	T
a [ channel ] is typically what you rent from a telephone company	transmission	T
The room has a wooden [ floor ] .	horizontal_surface level	T
negotiations ran into a brick [ wall ]	object physical_object	T
he was suffering from museum [ fatigue ]	boredom ennui tedium	T
geneticists only recently discovered the [ identity ] of the gene that causes it	recognition identification	T
the [ frequency ] of his seizures increased as he grew older	rate	T
Harry said he could n't stop and chat because his [ missus ] wanted to go shopping .	wife married_woman	T
the [ heart ] and soul of the Republican Party	content cognitive_content mental_object	T
what [ make ] of car is that ?	kind sort form variety	T
he is a lawyer with a sports [ background ]	inheritance heritage	T
keep the [ faith ]	commitment allegiance loyalty dedication	T
I hope I can keep up this [ streak ] of accomplishments .	succession	T
they allowed just one [ vote ] per person	choice selection option pick	T
they are up to [ date ]	present nowadays	T
A “ robber [ baron ] ” or “ robber knight ” is an historic term and title of disdain .	businessman man_of_affairs	T
his [ worry ] over the prospect of being fired	anxiety	T
there was no [ shortness ] of money	lack deficiency want	T
As the [ altitude ] increases , the temperature gets lower , so remember to bring warm clothes to the mountains .	elevation	T
they buried him in his best [ suit ]	garment	T
he was pleased by the audience 's [ reaction ] to his performance	response	T
the [ song ] of bullets was in the air	sound	T
a [ course ] of bricks	layer bed	T
they stayed in the [ pattern ] until the fog lifted	path route itinerary	T
Was that a [ yes ] ?	affirmative	T
what [ level ] is the office on ?	structure construction	T
the rumor had its [ origin ] in idle gossip	source	T
[ stream ] of consciousness	course line	T
Near - [ term ] , mid - term and long - term goals	time_period period_of_time period	T
each generation must have its own [ rebellion ]	resistance	T
the clarinet was out of [ tune ]	pitch	T
a cabbage [ patch ]	tract piece_of_land piece_of_ground parcel_of_land parcel	T
He 's such a poor cook , I ca n't believe he 's still in [ business ] !	commerce commercialism mercantilism	T
The [ class ] of 1982 was particularly noteworthy .	gathering assemblage	T
anthropologists do much of their work in the [ field ]	region	T
voltage [ peak ]	limit limitation	T
he slammed the [ door ] as he left	movable_barrier	T
He gave me a [ lift ] to the bus station .	drive ride	T
We had the [ chance ] to meet the president last week .	possibility possibleness	T
I 'm normally a big fan of [ lifesaving ] , but in his case we can make an exception .	rescue deliverance delivery saving	T
I arranged a [ date ] with my Australian business partners .	meeting get_together	T
his name is in all the [ record ] books	fact	T
Thwackum , on the contrary , maintained that the human mind , since the fall , was nothing but a sink of iniquity , till purified and redeemed by grace . The favourite phrase of the former , was the natural beauty of virtue ; that of the latter , was the divine [ power ] of grace .	quality	T
he looked like he had seen a [ ghost ]	apparition phantom phantasm phantasma fantasm shadow	T
this military [ post ] provides an important source of income for the town nearby	military_installation	T
much of the [ waste ] material is carried off in the sewers	material stuff	T
this [ receptiveness ] is the key feature in oestral behavior , enabling natural mating to occur	willingness	T
his [ defensiveness ] was manifested in hurt silence	sensitivity sensitiveness	T
A stock [ cube ]	regular_polyhedron regular_convex_solid regular_convex_polyhedron Platonic_body Platonic_solid ideal_solid	T
your [ choice ] of colors was unfortunate	action	T
there was a chemical [ reaction ] of the lime with the ground water	chemical_process chemical_change chemical_action	T
everyone hopes for a better [ tomorrow ]	future hereafter futurity time_to_come	T
he listened for the [ progress ] of the troops	change_of_location travel	T
she walked to a [ point ] where she could survey the whole street	location	T
that year there was a crop [ failure ]	fortune destiny fate luck lot circumstances portion	T
I like the [ cut ] of that suit .	fashion	T
the water reached ankle [ level ]	altitude height	T
to say the same [ thing ] in other terms	statement	T
a hard theory to put into [ practice ]	implementation effectuation	T
The change is due largely to the increased availability of antiretroviral [ treatment ] .	care attention aid tending	T
they developed a scheme of mutual [ support ]	aid assist assistance help	T
The [ resistance ] of bacteria to certain antibiotics	military_action action	T
no human [ situation ] is simple	difficulty	T
they moved in under a [ mask ] of friendship	concealment concealing hiding	T
he bought a new stereo [ system ]	instrumentality instrumentation	T
The [ lyric ] in line 3 does n't rhyme .	text textual_matter	T
the company tried to project an altruistic [ image ]	impression effect	T
[ hunger ] for affection	desire	T
they had to complete the [ sale ] before the banks closed	selling merchandising marketing	T
[ perversion ] also shows up in kinky telephone cords	curve curved_shape	T
she asked for money and then the [ fun ] began	activity	T
there was a three - story [ building ] on the corner	structure construction	T
Her favorite [ subject ] is physics .	knowledge_domain knowledge_base domain	T
the people concerned have a [ deficit ] in verbal memory	lack deficiency want	T
He ate a [ third ] of the pie . Divided by two - thirds .	interval musical_interval	T
the American public is experiencing scandal [ fatigue ]	boredom ennui tedium	T
She 's a [ kid ] . It 's normal for her to have imaginary friends .	juvenile juvenile_person	T
He slipped through an [ opening ] in the crowd .	space	T
I gave him a [ bit ] of my mind	small_indefinite_quantity small_indefinite_amount	T
he predicted that although it is of small [ account ] now it will rapidly increase in importance	importance	T
it was on the [ order ] of a mile	magnitude	T
a working [ stiff ]	man adult_male	T
the union was brought into [ submission ]	condition status	T
he cut a fine [ figure ]	impression effect	T
A horse hates having a [ bit ] put in its mouth .	stable_gear saddlery tack	T
the timing and [ control ] of his movements were unimpaired	bodily_process body_process bodily_function activity	T
He got a [ loan ] of five thousand pounds .	debt	T
the banjo had a long [ neck ]	part portion	T
Victorian furniture is an [ interest ] of mine .	diversion recreation	T
the team enjoyed a brief [ run ] of victories	sequence chronological_sequence succession successiveness chronological_succession	T
she has no peer in the [ concoction ] of mystery stories	invention innovation excogitation conception design	T
some students had stolen the [ key ] to the final exam	list listing	T
she preferred the black nylon [ number ]	merchandise ware product	T
My [ neighbour ] has an annoying cat .	person individual someone somebody mortal soul	T
he waited a long [ time ]	time_period period_of_time period	T
he made a good [ impression ]	appearance visual_aspect	T
the play was just a [ vehicle ] to display her talents	medium	T
the noisy [ voice ] of the waterfall	sound	T
a ship in [ distress ]	adversity hardship hard_knocks	T
The " Ring of the Nibelung " is a [ cycle ] of four operas by Richard Wagner , the famous nineteenth - century German composer .	series	T
the [ power ] of his love saved her	quality	T
he will hold office until the [ spring ] of next year	season time_of_year	T
spoke a good word in his friend 's [ behalf ]	sake interest	T
the news spread rapidly through the medical [ profession ]	occupational_group vocation	T
There is a lovely little [ church ] in the valley .	place_of_worship house_of_prayer house_of_God house_of_worship	T
they retreated in the face of withering enemy [ fire ]	attack onslaught onset onrush	T
it came by the first [ post ]	delivery bringing	T
his [ hand ] was illegible	writing	T
he wants to reconstruct the original [ text ]	matter	T
he ate his [ fill ] of potatoes	enough sufficiency	T
do you have a [ light ] ?	device	T
the expanded [ window ] will give us time to catch the thieves	time_period period_of_time period	T
there was too much for one [ person ] to do	causal_agent cause causal_agency	T
He changed seat to get a complete [ view ] of the stage .	look looking looking_at	T
both companies will retain control over the [ commercialization ] of their own products	exploitation development	T
" A great part of [ courage ] is the courage of having done the thing before . " —Ralph Waldo Emerson	spirit	T
a [ body ] of law	system scheme	T
[ unemployment ] is a serious social evil	state	T
the police are following a promising [ lead ]	evidence grounds	T
The Supreme Court upheld the principle of one person , one [ vote ] .	choice selection option pick	T
the [ war ] on poverty	campaign cause crusade drive movement effort	T
his reaction was the [ product ] of hunger and fatigue	consequence effect outcome result event issue upshot	T
She has two bachelor 's degrees and is studying towards a master 's [ degree ] .	award accolade honor honour laurels	T
from cradle to [ grave ]	death dying demise	T
The government provides [ support ] to the arts in several ways .	aid assist assistance help	T
the [ area ] of a rectangle	extent	T
Put a big sign on each [ face ] of the building that can be seen from the road .	surface	T
The girls were playing in the [ court ] .	area	T
I dropped in on the [ surgery ] as I was passing to show the doctor my hemorrhoids .	room	T
he works on [ commission ]	fee	T
After the power failure , we had to restore the database from [ backup ] .	duplicate duplication	T
That dress caught her [ eye ] .	attention attending	T
my father considered the [ commercialization ] of Christmas to be a sacrilege	exploitation development	T
stop being a [ baby ] !	person individual someone somebody mortal soul	T
the Union [ action ] of emancipating Southern slaves	group_action	T
The child was a [ charge ] of the nanny .	dependant dependent	T
had [ difficulty ] walking	effort elbow_grease exertion travail sweat	T
the battalion was a mere [ skeleton ] of its former self	minimum lower_limit	T
a [ head ] of lettuce	plant_organ	T
It 's been an [ age ] since we last saw you .	property	T
I 'm so grateful to God for the [ grace ] that He has given me .	beneficence	T
a [ wall ] of smoke	object physical_object	T
how it got out is a [ mystery ]	perplexity	T
The child 's [ breath ] came quickly and unevenly .	bodily_process body_process bodily_function activity	T
The boys were playing kickball in the mud ;    Steve is a [ boy ] of 16	male male_person	T
the [ mechanism ] of the ear	natural_object	T
they could not act without official [ communication ] from Moscow	act deed human_action human_activity	T
a colitis [ flare ]	attack	T
I 'm having a [ run ] of bad luck .	time_period period_of_time period	T
he gave a [ howl ] of pain	utterance vocalization	T
That store offers a variety of products .    We 've got to sell a lot of [ product ] by the end of the month .	commodity trade_good good	T
the [ repertory ] of the supposed feats of mesmerism	collection aggregation accumulation assemblage	T
He is so disgusting he makes my [ skin ] crawl .	body_covering	T
the harder the [ conflict ] the more glorious the triumph "-- Thomas Paine	group_action	T
they are accused of conspiring to constrain [ trade ]	commerce commercialism mercantilism	T
education is the [ door ] to success	entree access accession admission admittance	T
they resisted every effort on his [ part ]	concern	T
the [ school ] was built in 1932	building edifice	T
this [ multiplication ] of cells is a natural correlate of growth	increase increment growth	T
we spread our sleeping bags on the dry [ floor ] of the tent	horizontal_surface level	T
she beat some tough competition for the number one [ slot ]	status position	T
The [ seat ] of these trousers is almost worn through .	cloth_covering	T
We all have a [ part ] to play .	portrayal characterization enactment personation	T
I paid a high [ price ] for my folly .	cost	T
fortunately she had the good [ sense ] to run away	sagacity sagaciousness judgment judgement discernment	T
the [ quality ] of mercy is not strained "-- Shakespeare	attribute	T
armored from head to [ foot ]	vertebrate_foot pedal_extremity	T
he had a kidney [ transplant ]	operation surgery surgical_operation surgical_procedure surgical_process	T
We will consider performance issues under the [ head ] of future improvements .	subject topic theme	T
open to [ attack ] by the elements	degeneration devolution	T
the set of all rational numbers is a [ field ]	set	T
they had a good [ time ] together	experience	T
you need four people to play this [ game ]	activity	T
they admired his [ performance ] under stress	accomplishment achievement	T
his tools were in an orderly [ array ] on the basement wall	display	T
[ defense ] against hurricanes is an urgent problem	protection	T
The club has a busy [ calendar ] this year .	list listing	T
[ order ] ruled in the streets	state	T
I went to a lot of [ trouble ]	effort elbow_grease exertion travail sweat	T
the [ queen ] of ocean liners	personification	T
his absence is the [ hinge ] of our plan	circumstance	T
An example of a [ miracle ] associated with Muhammad is the splitting of the moon .	event	T
Their [ encounter ] was a matter of chance	convergence	T
a [ thread ] of smoke climbed upward	object physical_object	T
the coach said the offensive [ unit ] did a good job	organization organisation	T
how much is the [ damage ] ?	cost	T
it was a fight to the [ finish ]	downfall ruin ruination	T
Walk down the [ street ] .	thoroughfare	T
she kept a firm [ hold ] on the railing	grasping taking_hold seizing prehension	T
gawkers always try to get as close to the [ action ] as possible	work	T
I 'll be there in a [ bit ] ; I need to take care of something first .     He was here just a bit ago , but it looks like he 's stepped out .	time	T
she loaded her [ shopping ] into the car"women carrying home shopping did n't give me a second glance	commodity trade_good good	T
a [ tendency ] to be too strict	attitude mental_attitude	T
Put that [ light ] out !	source_of_illumination	T
the ship went aground in the [ channel ]	body_of_water water	T
these terms were used with a [ vagueness ] that suggested little or no thought about what each might convey	unclearness	T
a hook - and - ladder [ company ]	unit social_unit	T
it vanished into the [ night ]	dark darkness	T
a lengthy hospital [ stay ]	act deed human_action human_activity	T
there is a [ tension ] between these approaches to understanding history	balance	T
The judge leniently granted a sentence with no hard [ time ] .     He is not living at home because he is doing time .	term	T
to say they have priority is not to say they have complete [ hegemony ]	political_system form_of_government	T
the [ throat ] of a chimney	passage	T
the [ application ] of indexes to tables of data	action	T
he ruled that the criminal [ record ] of the defendant could not be disclosed to the court	list listing	T
a [ member ] of the faculty	associate	T
every [ number ] has a unique position in the sequence	definite_quantity	T
the home crowd cheered when Princeton took the [ field ]	tract piece_of_land piece_of_ground parcel_of_land parcel	T
he got [ change ] for a twenty and used it to pay the taxi driver	cash hard_cash hard_currency	T
Ryan wiped the [ tear ] from the paper he was crying on .	drop drib driblet	T
Lack of [ clarity ] on the part of the teacher will cause confusion among the students .	comprehensibility understandability	T
The [ cardinal ] number " three " can be represented as " 3 " or " three " .	number	T
The [ seat ] of a saddle	furniture piece_of_furniture article_of_furniture	T
the contents of a [ trojan ] can be a virus or a worm	malevolent_program	T
he looked around for the source of the [ disturbance ]	activity	T
The [ tumult ] of the elements	agitation	T
You have a two - hour [ window ] of clear weather to finish working on the lawn .	time_period period_of_time period	T
the written [ part ] of the exam	concept conception construct	T
a heart [ condition ]	illness unwellness malady sickness	T
the first [ shock ] of the earthquake came shortly after noon while workers were at lunch	earthquake quake temblor seism	T
he condemned religious [ sectarianism ]	narrow-mindedness narrowness	T
[ traffic ] on the internet is lightest during the night	communication communicating	T
This wood has the [ ability ] to fight off insects , fungus , and mold for a considerable time .	quality	T
She gave great [ head ] .	perversion sexual_perversion	T
the speed with which a program can be executed depends on the [ language ] in which it is written	communication	T
he enjoyed selling but he hated the [ travel ]	motion movement move	T
Every time we asked for an interview we got a [ denial ] .	speech_act	T
a [ set ] of books	collection aggregation accumulation assemblage	T
The [ class ] of all sets is not a set .	collection aggregation accumulation assemblage	T
He needs some time in the [ field ] before his judgment can be trusted .	region	T
I 'm making coleslaw ; do you know where the [ grater ] is ?	kitchen_utensil	T
A flexor , which bends a part , is the [ antagonist ] of an extensor , which extends it .	antagonistic_muscle	T
Oil [ field ] ;    gold field	land dry_land earth ground solid_ground terra_firma	T
his friendship was a [ comfort ]	gratification satisfaction	T
he celebrated his 10th [ season ] with the ballet company	time_period period_of_time period	T
the [ cup ] of her bra	concave_shape concavity incurvation incurvature	T
Within the [ compass ] of an encircling wall	capability capableness potentiality	T
Day and night ;    I work at night and sleep during the [ day ] .	time_period period_of_time period	T
we live in a litigious [ age ]	era epoch	T
what a revolting [ development ] !	change alteration modification	T
he wanted to live his own [ life ] without interference from others	being beingness existence	T
they stopped at an open [ space ] in the jungle	amorphous_shape	T
the defensive [ platoon ] of the football team	social_group	T
trade [ fair ]	gathering assemblage	T
Now that we 're all in agreement , we can put that issue to [ rest ] .	inaction inactivity inactiveness	T
give your home a [ facelift ]	renovation redevelopment overhaul	T
the [ formation ] of memories	creating_by_mental_acts	T
The Moon 's [ orbit ] around the Earth takes nearly one month to complete .	path route itinerary	T
files with a red [ tab ] will be stored separately	strip slip	T
it was great to feel my [ baby ] moving about inside	fetus foetus	T
she got a [ run ] in her stocking	damage harm impairment	T
I do it for the [ fun ] of it	diversion recreation	T
he is on the purchasing [ side ] of the business	aspect facet	T
he gave it up as a bad [ job ]	work	T
in England they call a slowpoke a [ slowcoach ]	dawdler drone laggard lagger trailer poke	T
a four - month [ stay ] in bankruptcy court	act deed human_action human_activity	T
boys in the village have probably been shooting [ vermin ]	pest	T
Thomas listened to his favorite [ song ] on the radio yesterday .	musical_composition opus composition piece piece_of_music	T
his [ state ] of health	attribute	T
We 're adding another [ wall ] in this room during the remodeling .	partition divider	T
he built a modest [ dwelling ] near the pond	housing lodging living_accommodations	T
he started the [ company ] in his garage	institution establishment	T
a [ wave ] of settlers	motion movement move motility	T
It 's become a [ habit ] of mine to have a cup of coffee after dinner .	custom tradition	T
Is there any [ news ] about the storm ?	information info	T
* Rear Adm. Harry Hill , put in command of the amphibious force , consults with local mariners and reaches a cautious consensus that [ neap ] high tide in the lagoon on November 20 will surely be close to five feet deep . — Michael Kernan , ( Tarawa ) " ... heavy fire ... unable to land ... issue in doubt . " , Smithsonian , Vol . 24 Issue 8 , p118 , 11p , 1c , 9bw , Nov , 1993	high_tide high_water highwater	T
one [ trouble ] after another delayed the job	difficulty	T
I could feel the runner 's [ breath ] on my shoulder .	air	T
I have little [ disposition ] now to do as you say .	attitude mental_attitude	T
a [ variant ] of the same word	type	T
convert all the measurements to [ metric ] units	unit_of_measurement unit	T
he dusted off the [ seat ] before sitting down	support	T
they had a fierce [ wrestle ]	struggle	T
he blamed his [ slip ] on the ice	mishap misadventure mischance	T
a [ fit ] of coughing	attack	T
Having people round for dinner was always quite an [ occasion ] at our house .	happening occurrence occurrent natural_event	T
For Freudians , [ libido ] means the desire to " unite and bind " with objects in the world .	sexual_desire eros concupiscence physical_attraction	T
humans have 22 [ chromosome ] pairs plus two sex chromosomes	body	T
The ballet dancer walked with a graceful [ attitude ]	bodily_property	T
An incident which happened about this time will set the characters of these two lads more fairly before the discerning reader than is in the [ power ] of the longest dissertation .	quality	T
what is the origin of the [ outwardness ] of our sensations of sound , smell , or taste	cognitive_state state_of_mind	T
the Democratic Party is an [ umbrella ] for many liberal groups	union unification uniting conjugation jointure	T
attempts to explain the origin of [ evil ] in the world	immorality	T
He performed in [ drag ] .	clothing article_of_clothing vesture wear wearable habiliment	T
* 1992 : Uncomfortably , I thought of the Bacchae : hooves and bloody ribs , scraps dangling from the fir trees . There was a word for it in Greek : [ omophagia ] . — Donna Tartt , The Secret History	eating feeding	T
meat [ loaf ]	food solid_food	T
a man of [ quality ]	social_station social_status social_rank rank	T
without him the [ dullness ] of her life crept into her work no matter how she tried to compartmentalize it .	unfeelingness callousness callosity hardness insensibility	T
He had worked in [ construction ] all his life .	commercial_enterprise business_enterprise business	T
he failed in his manner of [ address ] to the captain	manner_of_speaking speech delivery	T
in the political [ orbit ] of a world power	extent	T
An [ account ] of a battle .	record	T
the barber did a real [ job ] on my hair	work	T
a cartilaginous [ style ]	process outgrowth appendage	T
from the [ tone ] of her behavior I gathered that I had outstayed my welcome	quality	T
the soldiers were put on [ fatigue ] to teach them a lesson	assignment duty_assignment	T
they were sitting by the [ water ] 's edge	thing	T
the outcome justified the [ search ]	investigation investigating	T
they had a [ window ] of less than an hour when an attack would have succeeded	time_period period_of_time period	T
an [ outfitter ] provided everything needed for the safari	garmentmaker garment-worker garment_worker	F
the student [ body ]	body_part	F
they attacked the enemy 's [ line ]	differentiation distinction	F
that 's the [ size ] of the situation	magnitude	F
Printed [ matter ] ;    He always took some reading matter with him on the plane .	consequence import moment	F
it may rain in which [ case ] the picnic will be canceled	grammatical_category syntactic_category	F
there 's good [ stuff ] in that book	quality	F
he has a [ hold ] over them	pause intermission break interruption suspension	F
the [ reason ] a steady state was never reached was that the back pressure built up too slowly	faculty mental_faculty module	F
he went to law school out of [ respect ] for his father 's wishes	affection affectionateness fondness tenderness heart warmness warmheartedness philia	F
he tried to sing the tenor [ part ]	line	F
he gave the door a hard [ push ]	force	F
she threw the [ invitation ] away	allure allurement temptingness	F
he sensed the [ presence ] of danger	being beingness existence	F
they made a futile [ play ] for power	movability movableness	F
he is playing [ third ]	gear gear_mechanism	F
take a [ left ] at the corner	hand manus mitt paw	F
the cognitive [ operation ] of remembering	business_activity commercial_activity	F
this dish could use a [ touch ] of garlic	exteroception	F
he always blames someone else in the immediate [ neighborhood ]	indefinite_quantity	F
loss of blood is an important cause of [ shock ]	reflex reflex_response reflex_action instinctive_reflex innate_reflex inborn_reflex unconditioned_reflex physiological_reaction	F
did n't know the [ way ] home	distance	F
This song keeps going through my [ head ] .	striker	F
they gave full [ play ] to the artist 's talent	dramatic_composition dramatic_work	F
the [ sound ] awakened them	channel	F
She 's my love , my [ life ] .	experience	F
they put out quite a [ spread ]	disparity	F
The exploring party went through the high [ gap ] in the mountains .	delay holdup	F
an [ occasion ] arranged to honor the president	reason ground	F
[ confidence ] is always borrowed , never owned	certainty	F
the [ soul ] of honor	black_music African-American_music	F
the magnetic [ effect ] was greater when the rod was lengthwise	validity validness	F
Government and [ business ] could not agree	commerce commercialism mercantilism	F
What [ make ] of car do you drive ?	reordering	F
Today 's [ panel ] includes John Smith .	electrical_device	F
he hit the ball to deep [ center ]	object	F
he sailed around the [ world ]	group grouping	F
the [ change ] of government had no impact on the economy	thing	F
the [ coast ] is clear	motion movement move	F
arrogance and lack of [ taste ] contributed to his rapid success	experience	F
a piano was in one [ corner ] of the room	point	F
the so - called glorious experiment came to an inglorious [ end ]	ending conclusion finish	F
a remarkable [ degree ] of frankness	angular_unit	F
his saxophone was in [ pledge ]	commitment dedication	F
atheists do not enjoy a favorable [ position ] in American life	item point	F
there was a [ light ] at every corner	illumination	F
There was a [ catch ] in his voice when he spoke his father 's name .	game	F
she lost all [ respect ] for him	politeness civility	F
he wanted to feel a [ part ] of something bigger than himself	portrayal characterization enactment personation	F
the [ pursuit ] of love	motion movement move	F
the people slowly progressed from barbarism to [ civilization ]	excellence	F
He has a lot of [ interest ] in vintage cars .	social_group	F
The chimney [ corner ] was full of cobwebs .	area	F
the second [ movement ] is slow and melodic	action action_mechanism	F
you take a [ chance ] when you let her drive	possibility possibleness	F
they say he gives good [ head ]	top	F
the winning [ goal ] came with less than a minute left to play	content cognitive_content mental_object	F
a poor [ excuse ] for an automobile	note short_letter line billet	F
the [ course ] of the river	education instruction teaching pedagogy didactics educational_activity	F
the direction of maximum [ tension ] moves asymptotically toward the direction of the shear	balance	F
Membership of this golf club is limited to those of [ quality ] and wealth .	attribute	F
his novels always have a lot of [ action ]	process physical_process	F
they applied for an [ extension ] of the loan	meaning substance	F
You need to learn to be more tolerant of [ difference ] .	change	F
get to the [ point ]	measure quantity amount	F
Go to the supermarket and buy some [ tea ] .	herb	F
he has an unlisted [ number ]	amount	F
he occupied a [ post ] in the treasury	visual_signal	F
the policy so far is all [ stick ] and no carrot	leg	F
a bedside [ stand ]	defense defence defensive_measure	F
night [ spot ]	marking	F
he is out of [ action ]	mechanism	F
it was just [ smoke ] and mirrors	pitch delivery	F
settling a [ score ]	success	F
she was his main [ squeeze ]	compression compressing	F
it was debated whether saving [ grace ] could be obtained outside the membership of the church	beneficence	F
He cut a sorry [ figure ] standing there in the rain .	model simulation	F
he put flowers on his mother 's [ grave ]	death dying demise	F
all the salesmen met their [ quota ] for the month	trade_barrier import_barrier	F
he gave us a general [ formula ] for attacking polynomials	mathematical_statement	F
The accusative [ case ] canonically indicates a direct object .    Latin has six cases , and remnants of a seventh .	state_of_mind frame_of_mind	F
he got out of [ line ]	mark print	F
he sacrificed a [ piece ] to get a strategic advantage	creation	F
The English [ language ] ;    sign language	higher_cognitive_process	F
add it to my [ score ] and I 'll settle later	set	F
make [ way ] for	path route itinerary	F
Printing at higher [ resolution ] will cause a reduction in performance .	statement	F
the [ arrangement ] of the furniture	group grouping	F
matters came to a [ head ] yesterday	individual	F
the [ foot ] of the mountain	vertebrate_foot pedal_extremity	F
the boxer was a magnificent fighting [ machine ]	organization organisation	F
in a static [ system ] oil can not be replaced by water on a surface	group grouping	F
the trapped miners found a [ pocket ] of air	people	F
the [ explosion ] was heard a mile away	effusion gush outburst blowup ebullition	F
he threw a [ flare ] to the fullback who was tackled for a loss	attack	F
I 'm convinced that there was a [ presence ] in that building that I ca n't explain , which led to my heroic actions .	being beingness existence	F
he prepared his [ presentation ] carefully in advance	position posture attitude	F
the range and [ variety ] of his work is amazing	taxonomic_group taxonomic_category taxon	F
I am reading a good [ book ] on economics	record	F
he got a [ tip ] on the stock market	topographic_point place spot	F
he bought some [ reading ] material at the airport	measurement measuring measure mensuration	F
mailed an indignant [ letter ] to the editor	owner proprietor	F
The country [ set ]	exercise exercising physical_exercise physical_exertion workout	F
the market was up at the [ finish ]	perfection flawlessness ne_plus_ultra	F
The [ hollow ] of the hand or of a tree	valley vale	F
a [ corner ] on the silver market	area	F
the [ bite ] of satire	meal repast	F
a homeless [ tramp ]	footfall footstep step	F
players had to reserve a [ court ] in advance	deference respect	F
slices of hard - boiled egg on a [ bed ] of spinach	stratum	F
a [ stretch ] of clear water	duration continuance	F
she broke the record for the half - mile [ run ]	locomotion travel	F
you have n't got the [ heart ] for baseball	playing_card	F
the tires showed uneven [ wear ]	act deed human_action human_activity	F
is the [ direction ] of the economy a function of government ?	inclination disposition tendency	F
The mixer returned to the plant for another [ fill ] .	enough sufficiency	F
I was right in the middle of a [ stretch ] when the phone rang .	duration continuance	F
She lost all her respect and [ authority ] after turning up drunk to the meeting .	administrative_unit administrative_body	F
A rifle [ action ]	work	F
I had a strange [ feeling ] in my leg	state	F
The military [ academy ] at West Point ; a riding academy ; the Academy of Music .	establishment	F
[ energy ] can take a wide variety of forms	drive	F
the [ break ] seems to have been caused by a fall	pause	F
on the one [ hand ] ... , but on the other hand ...	writing	F
he tried to blame the victim but his success on that [ score ] was doubtful	resentment bitterness gall rancor rancour	F
charges of opposite [ sign ]	communication	F
He 's a sorry [ excuse ] of a doctor .	note short_letter line billet	F
tickets are $ 5 per [ head ]	domestic_animal domesticated_animal	F
there was a [ note ] of uncertainty in his voice	paper_money folding_money paper_currency	F
The [ surprise ] attack was devastating .	astonishment amazement	F
the plane turned to make a second [ pass ]	permission	F
he was ejected for protesting the [ call ]	telephone telephony	F
it was a [ case ] of bad judgment	state_of_mind frame_of_mind	F
he took his [ leave ]	permission	F
pottery was his [ life ]	time_period period_of_time period	F
he tried to catch her [ eye ]	hole	F
they were an angry [ lot ]	large_indefinite_quantity large_indefinite_amount	F
he had lost [ control ] of his sphincters	discipline	F
There are several species of wild flowers growing in this [ field ] .	land dry_land earth ground solid_ground terra_firma	F
a sudden [ recognition ] of the problem he faced	approval commendation	F
his instructions deliberately gave them the wrong [ set ]	abstraction abstract_entity	F
I 've got to go to the [ head ] .	cognition knowledge noesis	F
the [ development ] and printing of his pictures took only two hours	improvement melioration	F
the statue stood on a marble [ support ]	activity	F
He needs to regain her [ trust ] if he is ever going to win her back .	property belongings holding	F
[ authority ] for the program was renewed several times	expert	F
the political [ picture ] is favorable	illustration	F
there was a [ dip ] in the road	condiment	F
a briar [ patch ]	marking	F
he returned to the [ land ] of his birth	object physical_object	F
He looked at her for ten full minutes before [ recognition ] dawned .	organic_phenomenon	F
suddenly her gigantic power melted into [ softness ] for the baby	economic_condition	F
I could n't tell what the [ thing ] was	feeling	F
the dog 's woolly [ shag ]	fabric cloth material textile	F
Would male strippers be appropriate for the divorce [ shower ] ?	rain rainfall	F
a [ figure ] of $ 17 was suggested	illustration	F
Time stops for nobody .     the ebb and flow of [ time ]	moment minute second instant	F
a [ history ] of France	past past_times yesteryear	F
the [ head ] of the whole operation	domestic_animal domesticated_animal	F
the battery had a short [ life ]	being beingness existence	F
competition was pushing them to the [ wall ]	partition divider	F
he bought a [ book ] of stamps	collection aggregation accumulation assemblage	F
the TV program has a new time [ slot ]	slit	F
A [ force ] out was recorded on the scorecard .	physical_phenomenon	F
they put it into containers for [ ease ] of transportation	affluence richness	F
The name Cézanne is written with an acute [ accent ] .	importance grandness	F
he hoped for a new [ life ] in Australia	experience	F
I 'm worried that the [ load ] on that transformer will be too high .	indefinite_quantity	F
measures for the [ control ] of disease	criterion standard	F
this sweater is an all - wool [ number ]	performance public_presentation	F
If you were in my [ place ] what would you do ?	cognition knowledge noesis	F
she tends to make a big [ production ] out of nothing	creation	F
Georgie Fame plays all types of keyboards including electric piano , [ organ ] , and Hammond organ .	periodical	F
Nicklaus had a [ run ] of birdies	liberty	F
a bad [ reaction ] to the medicine	conservatism conservativism	F
He 's always stuffing his [ face ] with chips .	surface	F
what was your [ score ] on your homework ?	number	F
the thread would n't go through the [ eye ]	area country	F
a [ check ] on its dependability under stress	draft bill_of_exchange order_of_payment	F
under the [ head ] of minor Roman poets	beginning origin root rootage source	F
Let 's go for a [ run ] in the car .	liberty	F
it was a sturdy [ table ]	gathering assemblage	F
drop me a [ line ] when you get there	military_position position	F
her friends organized a baby [ shower ] for her when she was expecting	washup bathing	F
there was too much [ play ] in the steering wheel	activity	F
You can tell that the secret ingredient missing from New CokeTM was [ vanilla ] , because certain South American economies collapsed when it was introduced , and miraculously revived when the old formula was used again .	flavorer flavourer flavoring flavouring seasoner seasoning	F
politicians have to respect a mass [ movement ]	change	F
she was humming an [ air ] from Beethoven	region part	F
a public [ force ] is necessary to give security to the rights of citizens	causal_agent cause causal_agency	F
the Republican [ nomination ] for Governor	condition status	F
Shopping [ center ]	lineman	F
there was a [ reversal ] of autonomic function	turning turn	F
The [ head ] of the compass needle is pointing due north .	plant_organ	F
he encountered a general feeling of [ resistance ] from many citizens	capability capacity	F
The patient was bleeding on the right [ side ] .	aspect facet	F
his gross income was enough that he had to file a tax [ return ]	arrival	F
the pirates hid their [ treasure ] on a small island in the West Indies	collection aggregation accumulation assemblage	F
when these final episodes are broadcast it will be the [ finish ] of the show	end ending	F
I hope to become one of their [ number ] before I die	merchandise ware product	F
the [ reason ] that war was declared	fact	F
they are the progressive [ wing ] of the Republican Party	helping portion serving	F
Cut the skin with the [ point ] of the knife .	end terminal	F
he answered the first question willingly , the second reluctantly , and the [ third ] with resentment	gear gear_mechanism	F
in just a [ bit ]	unit_of_measurement unit	F
the [ pull ] up the hill had him breathing harder	force	F
the unlawful [ restraint ] of trade	restriction limitation	F
We went there by [ foot ] because we could not afford a taxi .	bottom	F
the [ sight ] of his wife brought him back to reality	look looking looking_at	F
it was all done in [ play ]	measure quantity amount	F
The [ shot ] was wide off the mark .	small_indefinite_quantity small_indefinite_amount	F
lightning produced an unusual [ union ] of the metals	set	F
it all happened in the [ space ] of 10 minutes	attribute	F
They endured a [ torrent ] of inquiries .	batch deal flock good_deal great_deal hatful heap lot mass mess mickle mint mountain muckle passel peck pile plenty pot quite_a_little raft sight slew spate stack tidy_sum wad	F
Suddenly , in the crowd , I felt a [ touch ] at my shoulder .	small_indefinite_quantity small_indefinite_amount	F
Karma 's a [ bitch ] .	canine canid	F
the jar had a wide [ mouth ]	opening gap	F
their nomadic [ mode ] of existence	condition status	F
he operated a [ bank ] of switches	ridge	F
they tracked him back toward the [ head ] of the stream	mark	F
the salesman 's [ call ] on a customer	animal_communication	F
[ economy ] of effort	frugality frugalness	F
Canst thou thunder with a [ voice ] like him ? — Job 40:9	sound	F
if you hurry you 'll catch the [ post ]	military_installation	F
the [ head ] of the nail " , " a pinhead is the head of a pin	subject topic theme	F
he walked to the [ front ] of the stage	social_group	F
an industrialized [ land ]	object physical_object	F
the cinema relies on apparent [ motion ]	proposal	F
in [ defense ] he said the other man started it	structure construction	F
He was an expert in the [ field ] of Chinese history .	tract piece_of_land piece_of_ground parcel_of_land parcel	F
a washing [ line ]	activity	F
they had to devise a [ system ] that did not depend on cooperation	body_part	F
Her [ youth ] and beauty is what attracted him to her .	time_of_life	F
he is a quick [ study ]	learning acquisition	F
men from the fraternal [ order ] will staff the soup kitchen today	magnitude	F
Our lounge strives to maintain an environment of [ peace ] for the comfort of our customers .	treaty pact accord	F
in [ return ] we gave them as good as we got	legal_document legal_instrument official_document instrument	F
he applied to the state for [ support ]	aid assist assistance help	F
the [ pain ] of loneliness	symptom	F
he was suspected of [ implication ] in several robberies	meaning substance	F
a [ head ] of steam	drug_user substance_abuser user	F
a large - scale farming [ operation ]	data_processing	F
We should meet at a pre - arranged [ point ] .	promontory headland head foreland	F
his [ conclusion ] took the evidence into account	section subdivision	F
[ par ] for this course is 72	status position	F
the whole [ floor ] complained about the lack of heat	horizontal_surface level	F
the [ house ] gets a percentage of every bet	building edifice	F
Apologizing for losing your temper , even though you were badly provoked , showed real [ class ] .	gathering assemblage	F
the armies met in the [ shock ] of battle	earthquake quake temblor seism	F
he won without any [ trouble ]	difficulty	F
Her church group has planned an adoption [ shower ] .	washup bathing	F
The newspaper is featuring a [ competition ] to win a car .	business_relation	F
this piano has a wonderful [ touch ]	perception	F
the program was on the [ air ] from 9 til midnight	gas	F
the material lost 2 inches per yard in [ shrinkage ]	larceny theft thievery thieving stealing	F
the succession of flashing lights gave an illusion of [ movement ]	social_group	F
the sole [ object ] of her trip was to see her children	constituent grammatical_constituent	F
his [ date ] never stopped talking	present nowadays	F
Take the [ lift ] to the fourth floor .	propulsion actuation	F
The average [ cost ] of a new house is twice as much as t was 20 years ago .	value	F
the title should be written at the [ top ] of the first page	plaything toy	F
he offered a persuasive [ defense ] of the theory	collection aggregation accumulation assemblage	F
a computer system provides [ utility ] programs to perform the tasks needed by most users	facility installation	F
one [ end ] of the box was marked ` This side up '	part section division	F
The dog barked at his own [ reflection ] in the mirror .	demonstration demo	F
That 's our finest [ cut ] of meat .	opening	F
We offer seafood as the first [ course ] .	education instruction teaching pedagogy didactics educational_activity	F
the [ break ] in the eighth frame cost him the match	separation breakup detachment	F
first you have to cut off the [ water ]	body_waste excretion excreta excrement excretory_product	F
he held the [ title ] for two years	legal_right	F
the [ head ] of the list	cognition knowledge noesis	F
[ drink ] was his downfall	food nutrient	F
he enjoyed the [ society ] of his friends	social_group	F
the very [ picture ] of a modern general	situation state_of_affairs	F
this cartridge has a powder [ charge ] of 50 grains	electrical_phenomenon	F
what is the [ point ] of discussing it ?	end terminal	F
the team is a [ unit ]	definite_quantity	F
they were in the [ eye ] of the storm	sense_organ sensory_receptor receptor	F
there has been [ talk ] about you lately	lecture lecturing	F
I 'll meet you at the [ foot ] of the stairs .	vertebrate_foot pedal_extremity	F
an angry [ face ]	surface	F
he spoke in a low [ key ]	list listing	F
the [ thrust ] of the jet engines	gesture	F
the big [ hand ] counts the minutes	side	F
the hurricane demolished houses in its [ path ]	course course_of_action	F
the table was covered with a [ film ] of dust	product production	F
he is remembered for his generosity and [ civilization ]	society	F
the [ opening ] received good critical reviews	change_of_integrity	F
his [ deference ] to her wishes was very flattering	courtesy good_manners	F
The shelves were lined with [ pottery ] of all shapes and sizes .	trade craft	F
We thought we would win but only ended up in fourth [ place ] .	situation position	F
his best [ finish ] in a major tournament was third	downfall ruin ruination	F
he held me up at the [ point ] of a gun	unit_of_measurement unit	F
Some people put the [ stress ] on the first syllable of “ controversy ” ; others put it on the second .	strain mental_strain nervous_strain	F
An executive or judical [ office ] ; a municipal office	place_of_business business_establishment	F
he was famous for his [ facility ] as an archer	service	F
the king will visit the duke 's [ court ]	deference respect	F
water is the [ element ] of fishes	situation state_of_affairs	F
a [ ball ] of mud caught him on the shoulder	baseball baseball_game	F
an [ art ] exhibition	creation creative_activity	F
the automobile reduced the [ demand ] for buggywhips	request petition postulation	F
an important [ piece ] of the evidence	creation	F
the [ work ] of an active imagination	occupation business job line_of_work line	F
your [ place ] or mine ?	situation position	F
the government took a firm [ course ]	education instruction teaching pedagogy didactics educational_activity	F
Most primates have a [ tail ] and fangs .	projection	F
the company operated at a [ loss ] last year	decline diminution	F
it takes time to learn the [ setup ] around here	equipment	F
I 'm going for a [ dip ] before breakfast .	condiment	F
there was a [ connection ] between eating that pickle and having that nightmare	union unification	F
He is an intellectual giant , and I have great [ respect ] for him .	politeness civility	F
The letter " G " was found in [ volume ] 4 .	sound_property	F
when that became known the price of their stock went into free [ fall ]	weakening	F
The [ population ] of New Jersey will not stand for this !	integer whole_number	F
there is a narrow [ line ] between sanity and insanity	conformity conformation compliance abidance	F
catastrophes make good [ copy ]	representation	F
he stuffed his [ mouth ] with candy	opening gap	F
some actresses have more than one face [ lift ]	lifting_device	F
they did n't have much in the [ way ] of clothing	journey journeying	F
the wine has a nutty flavor and a pleasant [ finish ]	happening occurrence occurrent natural_event	F
give me a [ hand ] with the chores	collection aggregation accumulation assemblage	F
metal [ fatigue ]	assignment duty_assignment	F
the [ formation ] of sentences	arrangement	F
he was indebted to the pioneering [ work ] of John Dewey	learning acquisition	F
the [ sum ] of all our troubles did not equal the misery they suffered	assets	F
I love hearing the [ song ] of canary birds .	sound	F
it is a [ center ] 's responsibility to get the football to the quarterback	object	F
at what [ stage ] are the social sciences ?	platform	F
The recipe calls for half a [ stick ] of butter .	limb tree_branch	F
he inserted the wedge into a [ split ] in the log	increase step-up	F
the police returned to the [ scene ] of the crime	bad_temper ill_temper	F
Where am I going to get my next [ hit ] ?	touch touching	F
give her [ recognition ] for trying	organic_phenomenon	F
he stepped into the [ light ]	device	F
in the common [ interest ]	curiosity wonder	F
a [ deal ] of trouble	agreement understanding	F
he gave his fingers a [ snap ]	noise	F
he left me an almost impossible [ shot ]	expert	F
mastering a second language requires a lot of [ work ]	geographic_point geographical_point	F
it set the [ stage ] for peaceful negotiations	platform	F
he must have a heart of [ stone ]	pericarp seed_vessel	F
the [ set ] of prime numbers is infinite	inclination disposition tendency	F
he was hospitalized for extreme [ fatigue ]	boredom ennui tedium	F
the [ separation ] of wheat from chaff	space	F
he was arrested on a [ charge ] of larceny	dependant dependent	F
The [ life ] of this milk carton may be thousands of years in this landfill .	being beingness existence	F
The [ stage ] pulled into town carrying the payroll for the mill and three ladies .	state	F
his parting [ shot ] was ` drop dead '	maneuver manoeuvre play	F
a nice [ line ] of shoes	formation	F
in English the subject and the verb must agree in [ number ]	company	F
if you 've time to spare go by [ air ]	gas	F
they accused the paper of biased [ coverage ] of race relations	extent	F
his [ etiolation ] signaled years in prison	bleach	F
O Marcus , I am warm'd ; my heart Leaps at the trumpet 's [ voice ] . —	sound	F
a man of [ action ]	group_action	F
he played with his rubber [ ball ] in the bathtub	pitch delivery	F
he warned against the [ use ] of narcotic drugs	utility usefulness	F
the [ extension ] of ` satellite of Mars ' is the set containing only Demos and Phobos	string	F
[ work ] equals force times distance	geographic_point geographical_point	F
that mountain is solid [ rock ]	natural_object	F
insiders said the company 's stock was in [ play ]	change alteration modification	F
the doctor - patient relationship is based on [ trust ]	friendship friendly_relationship	F
it is not known who created this [ piece ]	time	F
what [ price ] glory ?	cost	F
they got an early [ start ]	change_of_state	F
this project is his [ baby ]	girl miss missy young_lady young_woman fille	F
he gave an inaccurate [ account ] of the plot to kill the president	relationship	F
the [ development ] of Alaskan resources	district territory territorial_dominion dominion	F
he took a [ course ] in basket weaving	nutriment nourishment nutrition sustenance aliment alimentation victuals	F
there was a [ round ] of applause	helping portion serving	F
The [ court ] is now in session .	area	F
The [ volume ] of ticket sales decreased this week .	magnitude	F
police controlled the [ motion ] of the crowd	proposal	F
the essay contained too much [ detail ]	gang crew work_party	F
he asked for a poll of public [ opinion ]	message content subject_matter substance	F
he had a [ bit ] of good luck	stable_gear saddlery tack	F
she brought a [ change ] in her overnight bag	happening occurrence occurrent natural_event	F
the [ misery ] and wretchedness of those slums is intolerable	sadness unhappiness	F
a swelling with a [ disposition ] to rupture	attitude mental_attitude	F
The house is in [ order ] ; the machinery is out of order .	commercial_document commercial_instrument	F
he had a great [ feeling ] for music	state	F
the [ rule ] of St. Dominic	procedure process	F
his first job in Hollywood was as a [ double ] for Clark Gable	base_hit safety	F
the preachers and the bootleggers found they had a [ community ] of interests	world_organization world_organisation international_organization international_organisation global_organization	F
his back was to the [ wall ]	layer bed	F
most BASIC files use the filename [ extension ] .BAS	meaning substance	F
it was an excellent kick but the ball hit the [ bar ]	musical_notation	F
Having experienced both , the vampire decided that he preferred ( un)death to [ life ] .	time_period period_of_time period	F
his [ back ] was nicely tanned	cloth_covering	F
a ten day 's [ leave ] to visit his mother	permission	F
it was caused by an improbable [ concatenation ] of circumstances	series	F
I ca n't follow your [ line ] of reasoning	conformity conformation compliance abidance	F
they could still receive the sound but the [ picture ] was gone	typification exemplification	F
there is a [ law ] against kidnapping	collection aggregation accumulation assemblage	F
her red hat gave her outfit a [ splash ] of color	disturbance disruption commotion flutter hurly_burly to-do hoo-ha hoo-hah kerfuffle	F
Simply an [ identity ] element if both are true	recognition identification	F
he asked the waiter for the [ check ]	weave	F
fabric with a [ tendency ] to shrink	attitude mental_attitude	F
an idea is not a [ unit ] that can be moved from one brain to another	part portion component_part component constituent	F
the characters were well drawn but the [ plot ] was banal	scheme strategy	F
a five - pound beef [ heart ] will serve six	plane_figure two-dimensional_figure	F
I have [ confidence ] in our team	secret	F
he checked the [ point ] on his compass	disk disc saucer	F
a novel [ application ] of electronics to medical diagnosis	program programme computer_program computer_programme	F
the general [ term ] of an algebraic equation of the n - th degree	time_period period_of_time period	F
he gave a final [ set ] to his hat	abstraction abstract_entity	F
they served beer on [ draft ]	sketch study	F
the [ head ] of a comet	top	F
he cherished the [ faith ] of a good woman	institution establishment	F
My Russian [ vocabulary ] is very limited .	wordbook	F
the [ end ] of the year	surface	F
The rocky [ coast ] of Maine has few beaches .	motion movement move	F
The [ round ] of the seasons ; a round of pleasures	path track course	F
not a [ breath ] of scandal ever touched her	breeze zephyr gentle_wind air	F
The [ trend ] of a coastline ;    the upward trend of stock - market prices	inclination disposition tendency	F
he seemed more content in [ death ] than he had ever been in life	change alteration modification	F
hold your [ fire ] until you can see the whites of their eyes	fuel	F
It has become less common to say [ grace ] before having dinner .	beneficence	F
for English , a compositor will ordinarily have two such cases , the upper [ case ] containing the capitals and the lower case containing the small letters	person individual someone somebody mortal soul	F
she had a difficult [ delivery ]	expressive_style style	F
he had a [ pass ] for three days	cycle oscillation	F
My boss dumped a whole [ mess ] of projects on my desk today .	dining_room dining-room	F
you can lose your [ identity ] when you join the army	recognition identification	F
Be careful when you pet that dog on the [ head ] ; it may bite .	subject topic theme	F
it sounds good but what 's the [ catch ] ?	game	F
there is a constant [ hum ] of military preparation	noise	F
According to the Bible , the rainbow is a [ token ] of God 's covenant with Noah .	disk disc	F
Keep a firm [ hold ] on the handlebars .	confinement	F
her [ death ] came as a terrible shock	killing kill putting_to_death	F
he took a vicious [ cut ] at the ball	abuse insult revilement contumely vilification	F
he 's in the plumbing [ game ]	score	F
not openly liberal but that is the [ trend ] of the book	direction way	F
Do you know the [ date ] of the wedding ?	meeting get_together	F
his heroism saved a [ life ]	history account chronicle story	F
[ range ] of motion	facility installation	F
she seems to avoid much in the way of [ recognition ] or acknowledgement of feminist work prior to her own	approval commendation	F
the cloth had a pattern of red dots on a white [ surface ]	layer	F
marriage was scarcely his [ dish ]	nutriment nourishment nutrition sustenance aliment alimentation victuals	F
a [ patch ] of bad weather	marking	F
the professor did n't like his friends to use his formal [ title ]	high_status	F
the power of its engine determines its [ operation ]	business_activity commercial_activity	F
the beer had a large [ head ] of foam	domestic_animal domesticated_animal	F
the children were playing [ house ]	building edifice	F
the [ base ] of the triangle	military_installation	F
he was elected to a [ seat ] in the Senate	support	F
he admired the [ inclusion ] of so many ideas in such a short work	body	F
saw the board across the [ grain ]	atom molecule particle corpuscle mote speck	F
For our anniversary we went back to the same [ spot ] where we first met .	marking	F
A good [ title ] to an estate , or an imperfect title	right	F
his salary was determined by his [ rank ] and seniority	line	F
I have a [ run ] in my stocking .	locomotion travel	F
He 's packin ' a [ piece ] !	thing	F
there is an [ opening ] in the sales department	space	F
I need to rest for a [ piece ]	item	F
One of the planet 's moons has a slower [ spin ] than the others .	drive ride	F
Why the sad [ face ] ?	external_body_part	F
the party went with a [ swing ]	blow	F
they were arrayed in [ line ] of battle	reasoning logical_thinking abstract_thought	F
he broke into a [ run ]	sequence chronological_sequence succession successiveness chronological_succession	F
a friend in New Mexico said that the [ order ] caused no trouble out there	state	F
a relief pitcher took over in the [ top ] of the fifth	woman's_clothing	F
the fire - light gave a [ richness ] of coloring to that side of the room	wealth wealthiness	F
the [ union ] of opposing factions	political_unit political_entity	F
he got [ life ] for killing the guard	being beingness existence	F
the horse won by a [ neck ]	part portion	F
if I had my [ way ]	artifact artefact	F
In this [ reaction ] , the acid and base will neutralize each other , producing a salt .	bodily_process body_process bodily_function activity	F
the [ body ] of the car was badly rusted	body_part	F
The set of rational numbers , \mathbbQ , is the prototypical [ field ] .	visual_percept visual_image	F
no one wanted to play [ end ]	extremity	F
she refused to give them her Social Security [ number ]	merchandise ware product	F
he has a smooth [ line ] but I did n't fall for it	connection connexion connector connecter connective	F
good [ extension ] comes from a combination of training and native ability	expansion enlargement	F
they began to fight like [ fun ]	frivolity frivolousness	F
they used the elephants to help put up the [ circus ]	company troupe	F
Give him a [ hand ] .	laborer manual_laborer labourer jack	F
his faith was all the [ support ] he needed	aid assist assistance help	F
the ship made its [ run ] in record time	damage harm impairment	F
his sour [ breath ] offended her	bodily_process body_process bodily_function activity	F
the battle began with a cavalry [ charge ]	assertion averment asseveration	F
The [ connection ] between overeating and obesity	relation	F
the children acted out a comic [ piece ] to amuse the guests	work_of_art	F
The political [ left ] is not holding enough power .	hand manus mitt paw	F
The [ fringe ] of a picture	optical_phenomenon	F
My library [ subscription ] is about to expire .	handwriting	F
he got several girls in [ trouble ]	difficulty	F
a sample for ten days free [ trial ]	attempt effort endeavor endeavour try	F
John 's [ attendance ] for the conventions was not good .	company	F
an [ estimate ] of what it would cost	judgment judgement assessment	F
candidates must compete in a [ trial ] of skill	contest competition	F
Tap the [ head ] of the drum for this roll .	perversion sexual_perversion	F
the [ play ] lasted two hours	attempt effort endeavor endeavour try	F
but there is always the famous [ example ] of the Smiths	representation mental_representation internal_representation	F
he could hardly conceal his [ excitement ] when she agreed	emotional_arousal	F
a [ point ] of information	direction	F
booze will be the [ finish ] of him	perfection flawlessness ne_plus_ultra	F
he 's a master of the business [ deal ]	result resultant final_result outcome termination	F
he opened the window a [ crack ]	attempt effort endeavor endeavour try	F
the children were playing with [ lead ] soldiers	evidence grounds	F
American [ industry ] is making increased use of computers to control production	determination purpose	F
one [ foot ] of the chair was on the carpet	vertebrate_foot pedal_extremity	F
the [ cut ] from the accident scene to the hospital seemed too abrupt	share portion part percentage	F
she wiped lipstick from her [ mouth ]	opening	F
he bought a hot dog and a coke at the [ bar ]	barrier	F
the track [ bed ] had washed away	natural_depression depression	F
the [ strength ] of the company 's stock in recent weeks	intensity intensiveness	F
10.5 ( " ten [ point ] five " ; = ten and a half )	end terminal	F
the reflex [ motion ] of his eyebrows revealed his surprise	proposal	F
here we enter the [ region ] of opinion	location	F
he earned his [ degree ] at Princeton summa cum laude	temperature_unit	F
the [ back ] of the dental chair was adjustable	position place	F
I need to get a good [ rest ] tonight ; I was up late last night .	support	F
it was replaced because of its [ age ]	time_period period_of_time period	F
the [ head ] of the hammer	external_body_part	F
The sequence of reciprocals has zero as its [ limit ] .	extent	F
he walked to [ school ] every morning	animal_group	F
they were soon out of [ view ]	orientation	F
the plane 's [ operation ] in high winds	business_activity commercial_activity	F
only the [ top ] side of the box was painted	intensity intensiveness	F
he suffered from fatigue and emotional [ tension ]	stretching	F
she used a different [ color ] for the trim	kind sort form variety	F
his voice had an [ edge ] to it	limit demarcation demarcation_line	F
The [ conflict ] between the government and the rebels began three years ago .	incompatibility	F
all of human [ history ]	cognition knowledge noesis	F
The club that is now mostly used for golf was once a common [ weapon ] .	persuasion suasion	F
we congratulated him on his [ performance ] at the rehearsal	show	F
he is the beneficiary of a generous [ trust ] set up by his father	friendship friendly_relationship	F
he cashed a check at the [ bank ]	funds finances monetary_resource cash_in_hand pecuniary_resource	F
the [ course ] was less than a mile	education instruction teaching pedagogy didactics educational_activity	F
I heard a [ splash ] when the rock landed in the pond .	disturbance disruption commotion flutter hurly_burly to-do hoo-ha hoo-hah kerfuffle	F
They took a firm [ stand ] against copyright infringement .	vegetation flora botany	F
the [ figure ] was about a thousand	maneuver manoeuvre play	F
a [ head ] of cauliflower	individual	F
they claimed that they had been in [ contact ] with extraterrestrial beings	junction conjunction	F
It was written off as a [ loss ] .	failure	F
[ inwardness ] is what an Englishman quite simply has , painlessly , as a birthright	introversion	F
after that failure he lost his [ confidence ]	secret	F
they kept a firm [ grip ] on the two top priorities	appendage	F
the oceans are teeming with [ life ]	being beingness existence	F
IBM received an [ order ] for a hundred computers	condition status	F
it was a nice [ piece ] of work	thing	F
orders have recently picked up after a period of extreme [ softness ]	femininity muliebrity	F
A keen musical [ sense ]	meaning significance signification import	F
the [ order ] of Saint Benedict	magnitude	F
the [ ball ] was already emptying out before the fire alarm sounded	game_equipment	F
The storm did a lot of [ damage ] to the area .	cost	F
a [ thing ] of the spirit	happening occurrence occurrent natural_event	F
Put the batteries in the [ charger ] overnight so we can use them tomorrow .	warhorse	F
he studied the [ score ] of the sonata	set	F
the author gives a depressing [ picture ] of life in Poland	image mental_image	F
the familiar [ conflict ] between Republicans and Democrats	state	F
The office is in the [ gift ] of the President .	natural_ability	F
they tried to stop the [ escape ] of gas from the damaged pipe	running_away	F
" when bending the elbow the biceps are the [ agonist ] "	drug	F
The harmonic [ series ] has been much studied .	ordering order ordination	F
it brought the scandal to [ light ]	visual_property	F
We are enjoying a long [ engagement ] , but have n't yet set a date .	group_action	F
The [ face ] of this company .	facial_expression facial_gesture	F
he had a fair [ trial ] and the jury found him guilty	contest competition	F
it is always a [ job ] to contact him	duty	F
it was a miracle that he survived the [ drop ] from that height	decrease decrement	F
there was a [ connection ] via the internet	acquaintance friend	F
he put the lamp back in its [ place ]	cognition knowledge noesis	F
We used a [ poison ] to kill the weeds .	destructiveness	F
it was a mountainous [ area ]	environment	F
Magnolias belong to the [ division ] Magnoliophyta .	concept conception construct	F
sculpture is a [ form ] of art	document written_document papers	F
although he saw it in a different [ light ] , he still did not understand	device	F
A rugged [ complexion ] ;    a sunburnt complexion	point_of_view viewpoint stand standpoint	F
litmus paper turns red on [ contact ] with an acid	junction conjunction	F
he attributed the [ change ] to their marriage	cash hard_cash hard_currency	F
they are expecting a large [ vote ]	choice selection option pick	F
his victory is a [ certainty ]	cognitive_state state_of_mind	F
he dropped the logs on the [ ground ]	military_position position	F
a lonely [ way ] of life	position spatial_relation	F
peeling potatoes is a [ drag ]	clothing article_of_clothing vesture wear wearable habiliment	F
he made a [ scene ]	dramatic_composition dramatic_work	F
The [ path ] of a meteor , of a caravan , or of a storm	course course_of_action	F
city kids get to see the country at a summer [ camp ]	triteness staleness	F
a [ section ] of a fishing rod	division	F
his stories made him the [ center ] of the party	formation	F
Our shop was on the fourth [ story ] of the building , so we had to install an elevator .	record	F
[ war ] was declared in November but actual fighting did not begin until the following spring	campaign cause crusade drive movement effort	F
his [ treatment ] of the race question is badly biased	care attention aid tending	F
they built a fire at the [ mouth ] of the cave	rima	F
Every man is a fool in some man 's [ opinion ] .	message content subject_matter substance	F
he made trade [ protection ] a plank in the party platform	assets	F
Syngman Rhee kept imprisoned the Dowager Queen Yun Empress Sunjeong of the Korean Empire for fear of the [ respect ] the people held for her .	courtesy good_manners	F
he drew a [ heart ] and called it a valentine	disposition temperament	F
he was a [ bull ] of a man	bunk bunkum buncombe guff rot hogwash	F
it is still my [ play ]	dramatic_composition dramatic_work	F
during his first year in [ office ]	place_of_business business_establishment	F
follow God 's [ light ]	friend	F
the rifle had been fitted with a special [ stock ]	soup	F
the government 's weekly [ bite ] from my paycheck	injury hurt harm trauma	F
she knotted the [ end ] of the thread	content cognitive_content mental_object	F
there are three synagogues in the Jewish [ section ]	division	F
he made it the law of the [ land ]	occupation business job line_of_work line	F
[ tension ] holds the belt in the pulleys	stress	F
his [ drive ] and energy exhausted his co - workers	road route	F
The computer weather [ model ] did not correctly predict the path of the hurricane .	ideal	F
after two raises there was a [ call ]	visit	F
he said that architecture is the [ art ] of wasting space beautifully	superior_skill	F
you must wait in a long [ line ] at the checkout counter	persuasion suasion	F
he was unable to make his motion because he could n't get [ recognition ] by the chairman	understanding apprehension discernment savvy	F
he built himself a cabin in a [ hollow ] high up in the Appalachians	cavity enclosed_space	F
the [ despite ] in which outsiders were held is legendary	disregard neglect	F
at that [ point ] I had to leave	disk disc saucer	F
he drank a [ mixture ] of beer and lemonade	combining combine	F
An [ advance ] in health or knowledge	suggestion proposition proffer	F
his [ love ] for his work	score	F
used her parents ' [ influence ] to get the job	power force	F
he gave [ notice ] two months before he moved	attention attending	F
the [ howl ] of the wind made him restless	utterance vocalization	F
a component or constituent [ element ] of a system	situation state_of_affairs	F
[ corruption ] of a minor	immorality	F
a high [ liver ]	variety_meat organs	F
they got a bad connection and could hardly hear one another over the [ background ] signals	view aspect prospect scene vista panorama	F
Let 's get a [ quotation ] for repairing the roof before we decide whether it 's worth doing .	practice pattern	F
he has a happy [ disposition ]	attitude mental_attitude	F
they sailed south around the [ point ]	disk disc saucer	F
it was [ stuff ] I had heard before	object physical_object	F
A mother 's [ love ] is not easily shaken .	object	F
the [ addition ] of a leap day every four years	component constituent element	F
a girl 's [ education ] was less important than a boy 's	activity	F
put the kettle on the [ fire ]	combustion burning	F
the chef tasted the sauce with great [ satisfaction ]	change	F
events now in [ process ]	cognition knowledge noesis	F
the [ addition ] of cinnamon improved the flavor	acquisition	F
for the [ sake ] of argument	benefit welfare	F
While we 're in Brighton , let 's get a stick of [ rock ] !	natural_object	F
the fire spared the forest [ floor ]	horizontal_surface level	F
Mankind should develop [ reason ] above all other virtues .	rational_motive	F
he ate a large [ bag ] of popcorn	baggage luggage	F
subjects received a small electric [ shock ] when they made the wrong response	surprise	F
the child won everyone 's [ heart ]	internal_organ viscus	F
they saw the [ light ] of the beacon	source_of_illumination	F
whole fields of wheat in [ shock ]	surprise	F
he lost his [ place ] on the page	cognition knowledge noesis	F
I 'd like a big [ bit ] of cake , please .	unit_of_measurement unit	F
the [ passing ] of winter	success	F
they were at the [ head ] of the attack	structure anatomical_structure complex_body_part bodily_structure body_structure	F
he went through [ fire ] and damnation	fireplace hearth open_fireplace	F
he finally saw the [ light ]	scene	F
they proposed a new [ direction ] for the firm	position spatial_relation	F
he has a special [ place ] in my thoughts	residence abode	F
what was the date of [ submission ] of your proposal ?	condition status	F
it was his [ rule ] to take a walk before breakfast	direction instruction	F
it was a heavy play and the actors tried in vain to give [ life ] to it	history account chronicle story	F
dogs should be kept under [ restraint ]	restriction limitation	F
His claim to the property has come under [ question ] .	subject topic theme	F
the defensive line braced to stop the [ run ]	sequence chronological_sequence succession successiveness chronological_succession	F
Pittsburgh is the [ source ] of the Ohio River	publication	F
the pictures were at the same [ level ]	surface	F
it is a job requiring serious [ application ]	request petition postulation	F
he was responsible for the [ beginning ] of negotiations	happening occurrence occurrent natural_event	F
we have given it at the [ end ] of the section since it involves the calculus	state	F
The children were playing [ ball ] in the garden .	plaything toy	F
out of [ respect ] for his privacy	attitude mental_attitude	F
there was a [ grain ] of truth in what he said	foodstuff food_product	F
New York is at the [ mouth ] of the Hudson	opening	F
the controversy brought clearly into [ focus ] an important difference of opinion	concentration engrossment absorption immersion	F
the [ base ] of the lamp	bottom	F
He was mistreated while in police [ custody ] .	imprisonment internment	F
the main [ point ] on the agenda was taken up first	aim object objective target	F
the plane went into a steep [ bank ]	ridge	F
the saw buckled when it hit a [ knot ]	bunch clump cluster clustering	F
they will cut round [ stock ] to 1-inch diameter	repute reputation	F
he lost all [ feeling ] in his arm	state	F
the patient developed severe [ pain ] and distension	unpleasant_person disagreeable_person	F
there is strength in [ union ]	set	F
Pat and Leslie 's [ marriage ] to each other lasted forty years .	marital_status	F
What is the [ meaning ] of this proverb ?	message content subject_matter substance	F
Stop running all over the field and play your [ position ] !	state	F
There 's a $ 15 [ cover ] tonight .	fire firing	F
Her [ fringe ] is so long it covers her eyes .	optical_phenomenon	F
they run things by the [ book ] around here	publication	F
the gun was steadied on a special [ rest ]	inaction inactivity inactiveness	F
the resolution of one dissonance is often the [ preparation ] for another dissonance	activity	F
he did n't miss a single day of [ school ]	building edifice	F
the [ return ] of spring	income	F
Bob Dylan occupied the top [ slot ] for several weeks	slit	F
The organism has reached a crucial stage in its [ development ] .	district territory territorial_dominion dominion	F
A salamander darted out of an [ opening ] in the rocks .	start	F
I saw through his little [ game ] from the start	activity	F
he spent hours looking for the [ source ] of that quotation	communicator	F
The [ heart ] and soul of any democracy is its electorate .	courage courageousness bravery braveness	F
I have known him all his [ life ]	history account chronicle story	F
he got in [ touch ] with his colleagues	manner mode style way fashion	F
As he spoke , the knight - errant , who had remounted his [ warhorse ] , galloped forward to the royal stand , with a silken kerchief bound round his wounded arm . — Arthur Conan Doyle , The White Company , Chapter 26 .	expert	F
his [ claim ] on her attentions	assertion averment asseveration	F
murder in the second [ degree ]	angular_unit	F
he finally got his big [ break ]	delay holdup	F
I paid with a twenty and pocketed the [ change ]	happening occurrence occurrent natural_event	F
the facts had been brought to the [ surface ]	layer	F
My jacket needs a [ wash ] .	business_activity commercial_activity	F
it was several days after the storm before they could repair the [ washout ] and open the road	soil_erosion	F
he was at the [ head ] of the column	perversion sexual_perversion	F
physicists study both the nature of [ matter ] and the forces which govern it	writing written_material piece_of_writing	F
the [ lap ] of the shingles should be at least ten inches	touch touching	F
they made a [ stopover ] to visit their friends	stop	F
he wanted a [ shot ] at the champion	blow	F
he followed the deer 's [ slot ] over the soft turf to the edge of the trees	receptacle	F
this is a nice [ place ] for a picnic	cognition knowledge noesis	F
he was numb with [ shock ]	damper muffler	F
he was fighting to his last [ breath ]	suggestion proposition proffer	F
he was admitted to the [ bar ] in New Jersey	pressure_unit	F
a [ bit ] of lint	stable_gear saddlery tack	F
Would you like to come round on Sunday for a [ spot ] of lunch ?	marking	F
he lived on a worldly [ plane ]	shape form	F
a [ ceremony ] commemorating Pearl Harbor	activity	F
How do you sleep at [ night ] when you attack your kids like that ! ?	dark darkness	F
she had a [ habit ] twirling the ends of her hair	growth growing maturation development ontogeny ontogenesis	F
it 's only a [ step ] to the drugstore	interval musical_interval	F
He comes from a [ place ] near Chicago	passage	F
a growing [ realization ] of the risk involved	consummation	F
he paused on the bottom [ step ]	locomotion travel	F
she retained that bold [ effect ] in her reproductions of the original painting	impression feeling belief notion opinion	F
their [ love ] left them indifferent to their surroundings	sexual_activity sexual_practice sex sex_activity	F
The farmer 's [ field ] was a civil war battleground , and relics such a minnie bullets were frequently found while plowing .	visual_percept visual_image	F
I have [ faith ] in the goodness of my fellow man .	commitment allegiance loyalty dedication	F
I am a British [ subject ] .	thing	F
the alkaline [ inclination ] of the local waters	liking	F
The [ emission ] of heat from a fire	material stuff	F
in the abdominal [ region ]	location	F
his [ threat ] to kill me was quite explicit	danger	F
he took the family for a [ drive ] in his new car	mechanism	F
He went to Las Vegas and spent all his money over a three - day [ run ] .	stream watercourse	F
he built the house on [ land ] leased from the city	political_unit political_entity	F
on his [ return ] from Australia we gave him a welcoming party	income	F
[ loss ] of livestock left the rancher bankrupt	decline diminution	F
he ducked under the [ nose ] of the gun	chemoreceptor	F
moved from third to fifth [ position ]	bodily_property	F
the horse was not accustomed to a [ bit ]	time	F
After careful [ reflection ] , I have decided not to vote for that proposition .	picture image icon ikon	F
there was an informal [ meeting ] in my living room	assembly assemblage gathering	F
I wanted to create an [ impression ] of success	press pressure pressing	F
he knocked lightly on the closed door of the [ study ]	memorizer memoriser	F
the broadcast reached an [ audience ] of millions	conference group_discussion	F
he had a [ number ] of chores to do	performance public_presentation	F
he used a large [ book ] as a doorstop	section subdivision	F
the events left a permanent [ impression ] in his mind	concave_shape concavity incurvation incurvature	F
he 's not in my [ line ] of business	series	F
The lioness was a [ mother ] of four cubs .	inspiration	F
This is a [ product ] of lime and nitric acid .	consequence effect outcome result event issue upshot	F
it made a [ dent ] in my bank account	depression impression imprint	F
he missed the [ point ] of the joke	convex_shape convexity	F
his resentment took the [ form ] of extreme hostility	structure	F
I knew his name perfectly well but I had a temporary [ block ]	artifact artefact	F
write your name in the [ space ] provided	time_interval interval	F
then we embarked on the second [ stage ] of our Caribbean cruise	coach four-in-hand coach-and-four	F
a good [ lead ] for a job	leadership leading	F
they agreed about the [ difficulty ] of the climb	effort elbow_grease exertion travail sweat	F
his [ title ] to fame	legal_document legal_instrument official_document instrument	F
a [ lot ] of money	tract piece_of_land piece_of_ground parcel_of_land parcel	F
a [ branch ] of Congress	subfigure	F
the [ dog ] barked all night	support	F
he longed for the [ touch ] of her hand	manner mode style way fashion	F
the [ luck ] of the Irish	phenomenon	F
the climate had the [ softness ] of the south of France	indulgence lenience leniency	F
[ art ] does not need to be innovative to be good	superior_skill	F
The ship changed its [ course ] 15 degrees towards south .	direction way	F
they called for artillery [ support ]	resource	F
the [ lead ] was in the dummy	evidence grounds	F
Brigitte Bardot was a renowned [ beauty ] .	exemplar example model good_example	F
from the window he could catch a [ glimpse ] of the lake	look looking looking_at	F
I summoned the waiter , paid the [ check ] , and hurried to leave .	inspection review	F
the [ cover ] concealed their guns from enemy aircraft	natural_object	F
Your mother is a right [ pain ] .	somesthesia somaesthesia somatesthesia somatic_sensation	F
he took a [ drag ] on his cigarette and expelled the smoke slowly	clothing article_of_clothing vesture wear wearable habiliment	F
We looked through the [ glass ] to see stars .	containerful	F
he determined the [ length ] of the shortest line segment joining the two points	section segment	F
the [ party ] of the first part	organization organisation	F
I took over his [ practice ] when he retired	cognition knowledge noesis	F
he 's out of my [ orbit ]	extent	F
That engineer is a [ credit ] to the team .	attainment	F
the [ devotion ] of his time and wealth to science	love	F
My cat often sleeps on my [ bed ] .	stratum	F
in your [ heart ] you know it is true	courage courageousness bravery braveness	F
He ran to [ safety ]	device	F
there was a [ break ] in the action when a player was hurt	score	F
an early movie simply showed a long kiss by two actors of the contemporary [ stage ]	coach four-in-hand coach-and-four	F
the [ movement ] of cargo onto the vessel	defecation laxation shitting	F
He drew a [ line ] on the chart	depression impression imprint	F
the [ wall ] followed the road	stratum	F
in England they call a [ period ] a stop	fundamental_quantity fundamental_measure	F
he just did it for [ effect ]	validity validness	F
Magnolias belong to the [ order ] Magnoliales .	magnitude	F
The [ roll ] of a ball	rotation revolution gyration	F
If your dick has " the drip " you probably have the [ clap ] and need to go to the sex clinic .	noise	F
one of the tires developed a [ leak ]	disclosure revelation revealing	F
every dog has his [ day ]	work_time	F
he examined the child 's head for [ vermin ]	bad_person	F
increased expenses put a [ squeeze ] on profits	constriction	F
the astronauts walked in outer [ space ] without a tether	amorphous_shape	F
I wish I had seen the look on his [ face ] when he got the news	person individual someone somebody mortal soul	F
he deserves his [ day ] in court	era epoch	F
there as a [ trail ] of blood	evidence grounds	F
[ contact ] with the pier scraped paint from the hull	communication communicating	F
he threw away the [ rest ]	inaction inactivity inactiveness	F
He showed me the river of living [ water ] , sparkling like crystal , flowing from the throne of God .	food nutrient	F
she enjoyed her brief [ taste ] of independence	exteroception	F
he appointed himself emperor for [ life ]	being beingness existence	F
artists must study the [ structure ] of the human body	cognition knowledge noesis	F
the [ control ] condition was inappropriate for the conclusions he wished to draw	mechanism	F
an emerging professional [ class ]	education instruction teaching pedagogy didactics educational_activity	F
he was cut down on a close play at [ third ]	interval musical_interval	F
the catcher made a good [ throw ] to second base	opportunity chance	F
it is growing rapidly with no [ limitation ] in sight	time_limit	F
the [ break ] in the dam threatened the valley	score	F
we ca n't do it unless we establish some [ system ] around here	body_part	F
suddenly they were in a [ slack ] and the water was motionless	deterioration decline_in_quality declension worsening	F
the hypotenuse of a right triangle is always the longest [ side ]	surface	F
halt in the [ name ] of the law	family family_line folk kinfolk kinsfolk sept phratry	F
he could no longer cope with the complexities of [ life ]	being beingness existence	F
` let me show you my etchings ' is a rather worn [ line ]	merchandise ware product	F
Put a [ check ] mark in the box corresponding to the correct answer .	inspection review	F
The Moon is a natural [ satellite ] of the Earth .	equipment	F
they made a [ check ] of their equipment	draft bill_of_exchange order_of_payment	F
a life of luxury and [ ease ]	quality	F
the Germans were desperately trying to contain the Anzio [ beachhead ]	accomplishment achievement	F
a [ number ] 13 shoe	merchandise ware product	F
being in [ office ] already gives a candidate a great advantage	staff	F
they always sat on the right [ side ] of the church	unit social_unit	F
The [ floor ] of a cave served the refugees as a home .	horizontal_surface level	F
everyone got a [ cut ] of the earnings	shortening	F
he took a long [ lead ] off first	section subdivision	F
a comedy [ series ]	group grouping	F
she has a glib [ tongue ]	projection	F
the literacy [ rate ]	temporal_property	F
the crowded [ canvas ] of history	mat gym_mat	F
although her popular [ image ] was contrived it served to inspire music and pageantry	set	F
We sat around the [ fire ] singing songs and telling stories .	fuel	F
there was a [ note ] of gaiety in her manner	comment commentary	F
I have to take a [ leak ] .	disclosure revelation revealing	F
Convention [ center ]	lineman	F
a mental [ case ]	container	F
he always turns first to the business [ section ]	division	F
It was a [ mercy ] that we were not inside when the roof collapsed	lenience leniency	F
we are in [ accord ] with your proposal	harmony concord concordance	F
the game was interrupted by a brief [ shower ]	washup bathing	F
as they say in the [ trade ]	commerce commercialism mercantilism	F
he is an [ authority ] on corporate law	control	F
the house had a neglected [ air ]	wind air_current current_of_air	F
a [ mess ] of porridge	large_indefinite_quantity large_indefinite_amount	F
The queen and her [ court ] traveled to the city to welcome back the soldiers .	area	F
he stuck the [ point ] of the knife into a tree	characteristic	F
the safety of the ship is the captain 's [ concern ]	sympathy fellow_feeling	F
we enjoyed our [ round ] of the local bars	path track course	F
it came to a [ stop ] at the bottom of the hill	topographic_point place spot	F
he lived at a fast [ pace ]	indefinite_quantity	F
After the fire a still small [ voice ] . — 1 Kings 19:12	means agency way	F
the [ solution ] took three hours	statement	F
the wire has an [ extension ] of 50 feet	expansion enlargement	F
he had a bowel [ movement ]	action action_mechanism	F
the unkindest [ cut ] of all	shortening	F
the room was a mess because he had n't expected [ company ]	social_gathering social_affair	F
Canada is a [ member ] of the United Nations	part portion component_part component constituent	F
he needed [ silence ] in order to sleep	condition status	F
he asked to see the executive who handled his [ account ]	importance	F
There was a [ fire ] at the school last night and the whole place burned down .	combustion burning	F
a piano has a greater [ range ] than the human voice	assortment mixture mixed_bag miscellany miscellanea variety salmagundi smorgasbord potpourri motley	F
he was at the top of his [ form ]	document written_document papers	F
he did n't want his wife to know of the [ relationship ]	relation	F
he played a [ shtik ] Beethoven	business stage_business byplay	F
he 's [ family ]	lineage line line_of_descent descent bloodline blood_line blood pedigree ancestry origin parentage stemma stock	F
The [ flight ] of a refugee	creativity creativeness creative_thinking	F
great [ progress ] in the arts	change_of_location travel	F
ancient Egyptians believed in the [ divinity ] of the Pharaohs	discipline subject subject_area subject_field field field_of_study study bailiwick	F
he tried to understand their [ system ] of classification	instrumentality instrumentation	F
I expected a brief [ account ]	importance	F
she has a lot of [ class ]	collection aggregation accumulation assemblage	F
the teacher asked how many people made up his [ home ]	residence abode	F
he read his [ newspaper ] at breakfast	publisher publishing_house publishing_firm publishing_company	F
his [ charge ] was deliver a message	liabilities	F
he was sidelined with a hamstring [ pull ]	force	F
has a happy [ lot ]	large_indefinite_quantity large_indefinite_amount	F
he failed to get the Black [ vote ]	franchise enfranchisement	F
I tried to follow her [ prescription ] for success	medicine medication medicament medicinal_drug	F
the chairman 's nephew has a lot of [ pull ]	force	F
it contains approximately a [ third ] of the minimum daily requirement	interval musical_interval	F
He put some [ spin ] on the cue ball .	rotation rotary_motion	F
Your [ header ] is too long ; " Local Cannibals " will suffice .	jump jumping	F
the [ crash ] occurred during a thunderstorm and the system has been down ever since	hit hitting striking	F
he felt better after a little [ sleep ]	death	F
you ca n't do that in a university [ setting ]	environment environs surroundings surround	F
how could you do such a [ thing ] ?	feeling	F
the pregnancy was a [ stroke ] of bad luck	mark print	F
he volunteered to taste her latest [ concoction ]	invention innovation excogitation conception design	F
We had a [ feast ] to celebrate the harvest .	meal repast	F
they joined the wagon [ train ] for safety	piece_of_cloth piece_of_material	F
It is important to use [ flux ] when soldering or oxides on the metal will prevent a good bond .	change	F
the [ play ] of light on the water	movability movableness	F
his paintings reveal a sensitive [ interpreter ] of nature	program programme computer_program computer_programme	F
he had no documents confirming his [ title ] to his father 's estate	name	F
his [ weakness ] increased as he became older	preference penchant predilection taste	F
he visited during my [ absence ]	lack deficiency want	F
the [ bank ] is on the corner of Nassau and Witherspoon	array	F
your [ assumption ] that I would agree was unwarranted	postulate posit	F
a broad [ movement ] of the electorate to the right	social_group	F
[ language ] sets homo sapiens apart from all other animals	communication	F
a military [ buildup ] in preparation for the invasion	accretion accumulation	F
he did a funny [ impression ] of a politician	imprint	F
this form of [ conflict ] is essential to Mann 's writing	state	F
his [ lap ] was covered with food stains	sphere domain area orbit field arena	F
Keep going in the same [ direction ] .	concentration engrossment absorption immersion	F
England scored a goal at the [ death ] to even the score at one all .	end ending	F
he played a [ trick ] on me	customer client	F
putting them in [ readiness ]	effortlessness	F
the forces of [ reaction ] carried the election	chemical_process chemical_change chemical_action	F
an armed guard sat in the [ box ] with the driver	rectangle	F
he had an unruly [ shock ] of black hair	earthquake quake temblor seism	F
I went into the salon to get a [ clip ] .	case instance example	F
a [ train ] of thought	piece_of_cloth piece_of_material	F
A [ return ] to one 's question	repeat repetition	F
the [ depth ] of the water	region part	F
standing on the [ corner ] watching all the girls go by	area country	F
he was winning until he got a [ split ] in the tenth frame	increase step-up	F
Do you know the [ way ] to the airport ?	share portion part percentage	F
a student 's [ attendance ] is an important factor in her grade	group_action	F
The accident was a good [ lesson ] to me .	school_assignment schoolwork	F
he was well aware of the [ richness ] of his own appearance	wealth wealthiness	F
[ softness ] is not something permitted of good leaders	economic_condition	F
they broke [ faith ] with their investors	institution establishment	F
he has a [ touch ] of rheumatism	tactile_property feel	F
under [ control ]	bodily_process body_process bodily_function activity	F
Start at the beginning and go on until you come to the [ end ]	state	F
the [ press ] of business matters	machine	F
jogging works off my excess [ energy ]	drive	F
pottery of this [ cast ] was found throughout the region	appearance visual_aspect	F
I 'm leaving work early because I have a doctor 's [ appointment ] .	decision determination conclusion	F
the [ integrity ] of the nervous system is required for normal development	honesty honestness	F
